UNITID_P,Address,City,State,ZIP,men_total,women_total,Total
177834001,800 W. Jefferson St.,Kirksville,MO,63501,1582,2135,3717
222178001,1600 Campus Court,ABILENE,TX,79601,1934,3270,5204
138558001,2802 MOORE HWY,TIFTON,GA,317942601,1863,2428,4291
108232001,79 NEW MONTGOMERY,SAN FRANCISCO,CA,94105,4333,6283,10616
126182001,208 EDGEMONT BLVD,ALAMOSA,CO,811010001,1469,1641,3110
188429001,ONE SOUTH AVE,GARDEN CITY,NY,11530,2496,5650,8146
188438001,640 BAY RD,QUEENSBURY,NY,12804,1633,2094,3727
142832001,17 North Dearborn Street,Chicago,IL,606024310,266,1130,1396
168528001,110 S. Madison Street,Adrian,MI,49221,974,882,1856
133872001,671 Winyah Drive,ORLANDO,FL,32803,363,1342,1705
138600001,141 E COLLEGE AVE,DECATUR,GA,300303797,5,1025,1030
134811001,1501 Biscayne Blvd.,MIAMI,FL,33132,495,889,1384
217615001,2276 JEFFERSON DAVIS HIGHWAY,Graniteville,SC,29829,827,1440,2267
126207001,5401 W. 20th St.,Greeley,CO,80634,2665,3585,6250
100654001,4900 MERIDIAN ST,NORMAL,AL,35762,2381,3725,6106
100724001,915 SOUTH JACKSON ST,MONTGOMERY,AL,361040271,1597,2816,4413
199786001,1247 Jimmie-Kerr Road,GRAHAM,NC,272538000,1600,2648,4248
188526001,106 NEW SCOTLAND AVE,ALBANY,NY,122083492,519,812,1331
138716001,504 College Drive,Albany,GA,31705,1757,4614,6371
138682001,1704 South Slappey Boulevard,ALBANY,GA,317013514,1028,2153,3181
128498001,700 PROSPECT ST,NEW HAVEN,CT,65111189,441,1015,1456
168546001,611 E PORTER ST,ALBION,MI,49224,701,832,1533
210571001,1621 N. 13th St.,Reading,PA,196125234,772,1162,1934
175342001,"1000 ASU Drive, #359",ALCORN STATE,MS,390967500,1270,2388,3658
172918001,1601 JEFFERSON ST,ALEXANDRIA,MN,56308,1311,1303,2614
188641001,ONE SAXON DR,ALFRED,NY,148021205,1004,1298,2302
108807001,800 S. College Drive,Santa Maria,CA,934546399,5076,6209,11285
161688001,12401 WILLOWBROOK RD SE,CUMBERLAND,MD,215022596,872,1713,2585
210669001,520 N MAIN ST,MEADVILLE,PA,163353902,788,983,1771
154642001,1801 N COTTONWOOD,IOLA,KS,66749,975,1565,2540
110468001,10455 POMERADO ROAD,SAN DIEGO,CA,921311799,1193,2587,3780
168591001,614 W SUPERIOR,ALMA,MI,488011599,593,840,1433
168607001,665 JOHNSON ST,ALPENA,MI,49707,682,747,1429
210775001,400 SAINT BERNARDINE ST,READING,PA,196071799,828,1964,2792
238193001,3400 S 43RD  ST,Milwaukee,WI,532343922,58,1793,1851
222567001,3110 MUSTANG RD,ALVIN,TX,775114898,2424,3149,5573
222576001,2201 S. WASHINGTON,AMARILLO,TX,79178,3623,6231,9854
222628001,1700 Eastgate Dr,Garland,TX,750415595,407,775,1182
441052001,1200 N. Magnolia Ave.,Anaheim,CA,92801,279,748,1027
109040001,4021 Rosewood Ave,Los Angeles,CA,90004,239,1045,1284
447768001,3130 East Sedona Court,Ontario,CA,91764,277,1003,1280
241146001,PO BOX 62,BAYAMON,PR,960,,,
438586001,6600 PEACHTREE DUNWOODY RD 500 EMBASSY ROW,ATLANTA,GA,30328,576,1230,1806
164447001,1000 STATE ST,SPRINGFIELD,MA,1109,855,2297,3152
188854001,211 West 61st Street,NEW YORK,NY,10023,505,1171,1676
232797001,1813 E MAIN ST,SALEM,VA,24153,132,940,1072
453464001,3487 Belmont Ave,Youngstown,OH,44505,,,
449339001,111 W Congress St,Charles Town,WV,254141621,28925,17163,46088
109208001,4700 COLLEGE OAK DR,SACRAMENTO,CA,958414286,16725,14641,31366
240736001,PO BOX 2609,Pago Pago,AS,96799,319,718,1037
460738001,"2260 South Xanadu Way, Suite 310",Aurora,CO,80014,259,2415,2674
131159001,"4400 Massachsetts Avenue, NW",Washington,DC,200168068,5480,8831,14311
164465001,Boltwood Avenue,AMHERST,MA,10025000,919,936,1855
150066001,1100 E 5TH ST,ANDERSON,IN,460123495,736,986,1722
168740001,8975 US Hwy 31,BERRIEN SPRINGS,MI,49104,1822,1585,3407
222822001,3500 HWY 59 SOUTH,LUFKIN,TX,75904,1802,3117,4919
222831001,2601 W. Ave N,San Angelo,TX,76909,4275,6112,10387
164492001,50 SUNSET LANE,PAXTON,MA,16121198,728,733,1461
161767001,101 COLLEGE PKY,ARNOLD,MD,210121895,5218,7668,12886
172954001,1355 W HWY 10,ANOKA,MN,55303,828,1016,1844
172963001,"11200 MISSISSIPPI BLVD, NW",COON RAPIDS,MN,55433,3453,5392,8845
109350001,3041 West Avenue K,LANCASTER,CA,935365426,5875,8364,14239
188890001,24-02 Queensboro Plaza,Long Island City,NY,11101,1259,29,1288
197869001,B.B. Dougherty Admin. Building,BOONE,NC,28608,8141,10967,19108
168786001,1700 Fulton St. East,GRAND RAPIDS,MI,495061799,695,1063,1758
126289001,5900 S. Santa Fe Drive,Littleton,CO,80120,5915,5629,11544
211088001,450 S EASTON RD,GLENSIDE,PA,190383295,1071,2591,3662
448886002,411 N. Central Avenue,Phoenix,AZ,850042115,3922,7662,11584
420574002,7001 E. Williams Field Road,Mesa,AZ,852121812,3396,1699,5095
104151001,325 E. Apache Blvd.,TEMPE,AZ,852871812,29029,22556,51585
407009002,4701 W. Thunderbird Road,Glendale,AZ,853060153,1736,2709,4445
104160001,2020 S. Avenue 8E,YUMA,AZ,85365,3155,4279,7434
107327001,2501 S. Division,Blytheville,AR,723161109,543,879,1422
107318001,2000 W.  BROADWAY,WEST MEMPHIS,AR,723013829,528,895,1423
106449001,1000 IOWA STREET,BEEBE,AR,720121000,1377,2069,3446
106458001,PO Box 10,State University,AR,72467,5175,8534,13709
420538001,1600 South College Street,Mountain Home,AR,72653,542,803,1345
440402001,7648 VICTORY BLVD,NEWPORT,AR,721128912,902,1368,2270
106467001,"1509 N. Boulder Ave., Room 210",RUSSELLVILLE,AR,728012222,5360,6741,12101
109651001,1700 LIDA ST,PASADENA,CA,91103,1035,1214,2249
404994001,151 Lawrenece Street,Brooklyn,NY,11201,1516,2840,4356
156222001,204 N LEXINGTON AVE,WILMORE,KY,403901199,1060,630,1690
156213001,One Macklem Drive,WILMORE,KY,403901198,802,1138,1940
197887001,340 VICTORIA RD,ASHEVILLE,NC,288014897,2841,4051,6892
154022001,1310 19th Ave NW,CLINTON,IA,527332967,9927,24783,34710
156231001,1400 College Drive,Ashland,KY,411013683,1027,1515,2542
201104001,401 College Ave,Ashland,OH,448053702,3321,3306,6627
128577001,170 ELM ST,ENFIELD,CT,6082,1003,855,1858
164562001,500 SALISBURY ST,WORCESTER,MA,16091296,979,1449,2428
100812001,300 N BEATY ST,ATHENS,AL,35611,962,2082,3044
246813001,800 US Highway 29 N,ATHENS,GA,306011500,1659,2908,4567
138901001,1630 METROPOLITAN PKY SW,ATLANTA,GA,303104498,749,1438,2187
138840001,1560 METROPOLITAN PKWY SW,ATLANTA,GA,303104446,1217,2345,3562
183655001,5100 BLACK HORSE PIKE,MAYS LANDING,NJ,83302699,1918,3055,4973
132374001,4700 COCONUT CREEK PKY,COCONUT CREEK,FL,33063,3417,574,3991
241216001,COLTON ST. # 9,Guaynabo,PR,918,1186,497,1683
100858001,23 Samford Hall,Auburn,AL,36849,15420,15020,30440
100830001,7400 EAST DRIVE,MONTGOMERY,AL,361173596,1791,3420,5211
173045001,2211 RIVERSIDE AVE,MINNEAPOLIS,MN,55454,1409,2010,3419
138956001,3200 Augusta Tech Drive,AUGUSTA,GA,30906,1874,2535,4409
482149001,1120 15th Street,AUGUSTA,GA,30912,3041,5417,8458
143084001,639 38TH ST,ROCK ISLAND,IL,612012296,1104,1439,2543
219000001,2001 S SUMMIT AVE,SIOUX FALLS,SD,57197,738,1395,2133
454810001,"637 S Broadway, Ste H",Boulder,CO,80305,739,1550,2289
143118001,347 S GLADSTONE AVE,AURORA,IL,605064892,1851,4154,6005
222983001,900 N GRAND AVE,SHERMAN,TX,750904400,635,664,1299
222992001,5930 Middle Fiskville Road,Austin,TX,78752,17874,22925,40799
219602001,601 COLLEGE ST,CLARKSVILLE,TN,37044,4435,6519,10954
446048001,5050 Ave Maria Blvd,Ave Maria,FL,34142,542,580,1122
160320001,1355 Polders Lane,COVINGTON,LA,70433,101,2256,2357
176628001,11901 WORNALL RD,KANSAS CITY,MO,64145,591,1058,1649
109785001,901 E. Alosta Ave.,AZUSA,CA,917027000,3213,6882,10095
474863001,300 N. Lone Hill Avenue #200,San Dimas,CA,917731741,551,1809,2360
164580001,231 Forest Street,Babson Park,MA,24570310,1819,1538,3357
168847001,1050 West Bristol Road,Flint,MI,485079987,2837,6495,9332
154688001,618 EIGHTH STREET,BALDWIN CITY,KS,660060065,1129,1640,2769
109819001,1801 Panorama Drive,Bakersfield,CA,933051299,10862,13727,24589
201195001,275 EASTLAND RD,BEREA,OH,440172088,1630,2079,3709
150136001,2000 UNIVERSITY AVE,MUNCIE,IN,47306,7765,14119,21884
161864001,2901 LIBERTY HEIGHTS AVENUE,BALTIMORE,MD,212157893,1397,3126,4523
219639001,1003 MONROE AVE,MEMPHIS,TN,38104,113,951,1064
189088001,30 Campus Road,Red Hook,NY,12571,889,1318,2207
189097001,3009 BROADWAY,NEW YORK,NY,100276598,0,2562,2562
132471001,11300 NE 2ND AVE,MIAMI,FL,331616695,2463,4723,7186
109907001,2700 BARSTOW RD,BARSTOW,CA,923116608,1085,1967,3052
197911001,"200 ACC DRIVE, NE",WILSON,NC,278932575,384,675,1059
154697001,245 NE 30th Road,Great Bend,KS,67530,2046,2191,4237
235547001,14500 JUANITA DRIVE NE,KENMORE,WA,980284966,177,921,1098
160977001,"2 ANDREWS ROAD, 204 LANE HALL",LEWISTON,ME,4240,920,912,1832
235671001,1101 S Yakima Avenue,Tacoma,WA,98405,2453,1992,4445
437103001,201 Community College Drive,BATON ROUGE,LA,70806,3339,4903,8242
168883001,2001 N LINCOLN RD,ESCANABA,MI,498292511,694,1241,1935
164632001,588 LONGMEADOW ST,LONGMEADOW,MA,1106,192,3252,3444
223223001,"One Baylor Plaza, MS: BCM111",Houston,TX,770303411,705,876,1581
223232001,One Bear Place #97121,Waco,TX,767067121,7250,9967,17217
197966001,5337 US HIGHWAY 264 EAST,WASHINGTON,NC,27889,515,1028,1543
164720001,61 SEVER ST,WORCESTER,MA,16150071,761,1078,1839
175421001,1500 PEACHTREE ST,JACKSON,MS,39202,1290,2915,4205
156286001,2001 NEWBURG RD,LOUISVILLE,KY,402050671,1182,2187,3369
234669001,3000 LANDERHOLM CIRCLE SE,BELLEVUE,WA,980076484,5837,7389,13226
180814001,1000 GALVIN RD S,BELLEVUE,NE,680053098,4359,5262,9621
234696001,3028 Lindbergh Avenue,Bellingham,WA,982251599,1136,1180,2316
197984001,100 Belmont-Mt Holly Road,BELMONT,NC,280121802,777,779,1556
219709001,1900 BELMONT BLVD,NASHVILLE,TN,372123757,2870,5390,8260
238333001,700 COLLEGE ST,BELOIT,WI,535115595,577,698,1275
173124001,1500 BIRCHMONT DR NE,BEMIDJI,MN,566012699,2156,2955,5111
217721001,1600 Harden Street,Columbia,SC,29204,1031,1134,2165
154712001,1020 N 2ND ST,ATCHISON,KS,660021499,1023,1101,2124
145619001,5700 COLLEGE RD,LISLE,IL,605320900,1842,3098,4940
164739001,175 FOREST ST,WALTHAM,MA,24524705,3061,2399,5460
156295001,101 Chestnut Street,BEREA,KY,404042184,710,963,1673
183743001,400 PARAMUS RD,PARAMUS,NJ,76521595,6619,6733,13352
125170001,2050 Center Street,BERKELEY,CA,947041183,2769,3284,6053
189228001,3 E 43rd STREET,NEW YORK,NY,10017,1322,2374,3696
183789001,44 RIFLE CAMP RD,Woodland Park,NJ,7424,970,2498,3468
164748001,1140 BOYLSTON ST,BOSTON,MA,2215,4158,2805,6963
164775001,1350 WEST ST,PITTSFIELD,MA,12015786,593,1103,1696
139144001,2277 MARTHA BERRY HWY NW,MOUNT BERRY,GA,30149,781,1233,2014
183804001,617 6TH ST,LAKEWOOD,NJ,87012754,6655,0,6655
150145001,1001 Bethel Circle,MISHAWAKA,IN,46545,544,969,1513
173160001,3900 BETHEL DR,Arden Hills,MN,551126999,1325,2367,3692
132602001,640 Dr. Mary McLeod Bethue Blvd.,Daytona Beach,FL,321143099,1417,2356,3773
102429001,1411 Indiana Avenue,Jasper,AL,35501,1505,2240,3745
234711001,7662 CHANUTE ST,MOSES LAKE,WA,988373299,968,1076,2044
157553001,ONE BERT T COMBS DR,PRESTONSBURG,KY,41653,2097,2278,4375
196079001,"P. O. Box 6000, VESTAL PARKWAY EAST",BINGHAMTON,NY,139026000,8959,8809,17768
110097001,13800 BIOLA AVE,LA MIRADA,CA,906390001,2652,3457,6109
100937001,900 Arkadelphia Road,Birmingham,AL,35254,607,661,1268
102030001,351 NORTH BROAD STREET,MOBILE,AL,366035898,1193,1667,2860
200022001,1500 Edwards Avenue,Bismarck,ND,585065587,2134,1644,3778
143279001,6600 34TH AVE,MOLINE,IL,612655899,1700,2633,4333
219046001,1200 UNIVERSITY ST,SPEARFISH,SD,57799,1415,2620,4035
106625001,1410 HWY 304,POCAHONTAS,AR,72455,555,1027,1582
238397001,P.O. Box 5009,JANESVILLE,WI,535475009,853,1369,2222
198011001,HWY 41 WEST,DUBLIN,NC,28332,347,670,1017
223427001,902 COLLEGE AVE,BRENHAM,TX,778334098,10176,11447,21623
183822001,467 FRANKLIN ST,BLOOMFIELD,NJ,70033425,628,1057,1685
211158001,400 E SECOND ST,BLOOMSBURG,PA,17815,3692,5217,8909
208275001,2411 NW CARDEN AVE,PENDLETON,OR,97801,742,939,1681
446774001,13650 Apple Harvest Dr.,Martinsburg,WV,25403,2287,3986,6273
198039001,180 West Campus Drive,Flat Rock,NC,28731,944,1242,2186
231554001,3000 COLLEGE DR,BLUEFIELD,VA,24605,545,611,1156
237215001,219 ROCK ST,BLUEFIELD,WV,24701,454,821,1275
156392001,164 Opportunity Way,Lexington,KY,405112623,3903,5622,9525
217749001,1700 Wade Hampton Boulavard,Greenville,SC,296140001,1391,1614,3005
142115001,1910 UNIVERSITY DR,BOISE,ID,837251291,10846,14658,25504
158431001,6220 EAST TEXAS,BOSSIER CITY,LA,71111,2210,4386,6596
164924001,140 COMMONWEALTH AVE,CHESTNUT HILL,MA,24673961,6802,7918,14720
164988001,1 Silber Way,Boston,MA,2215,14306,20351,34657
161004001,5700 College Station,Brunswick,ME,40118448,903,925,1828
162007001,14000 JERICHO PARK RD,BOWIE,MD,207159465,2371,3949,6320
201432001,One University Drive,HURON,OH,448399791,689,1308,1997
201441001,220 MCFALL CTR,BOWLING GREEN,OH,43403,7610,9930,17540
143358001,1501 W BRADLEY AVE,PEORIA,IL,61625,2568,3314,5882
165015001,415 South Street,Waltham,MA,24539110,2385,3415,5800
262086001,16355 Laguna Canyon Road,Irvine,CA,92618,2991,5775,8766
223506001,500 COLLEGE DR,LAKE JACKSON,TX,775663199,2066,2245,4311
139199001,500 Washington Street S.E.,GAINESVILLE,GA,305013668,356,2486,2842
156356001,717 FREDERICA ST,OWENSBORO,KY,423013023,289,726,1015
152992001,3303 REBECCA ST,SIOUX CITY,IA,51104,517,712,1229
230010001,1301 N 600 W,LOGAN,UT,84321,749,596,1345
484932001,2001 Union Carbide Dr,South Charleston,WV,25303,652,1037,1689
231581001,402 E COLLEGE ST,BRIDGEWATER,VA,228121599,825,1032,1857
165024001,131 Summer Street,BRIDGEWATER,MA,23250001,4290,6700,10990
230047001,55-220 Kulanui Street,Laie,HI,967621294,1244,1932,3176
142522001,525 S CENTER,Rexburg,ID,834601650,17980,24361,42341
230038001,Brigham Young University,PROVO,UT,846026201,17623,16876,34499
165033001,777 Elsbree St,Fall River,MA,27207399,2608,4606,7214
183859001,765 NEWMAN SPRINGS RD,LINCROFT,NJ,77381597,5671,6185,11856
223524001,3939 VALLEY VIEW LN,FARMERS BRANCH,TX,752444997,5644,8082,13726
104090001,"2445 W. Dunlap Avenue, Suite 100",Phoenix,AZ,85021,213,1038,1251
189501001,250 JORALEMON STREET,BROOKLYN,NY,11201,470,562,1032
132709001,3501 SW Davie Rd,Davie,FL,33314,16479,24305,40784
217156001,Prospect St,PROVIDENCE,RI,2912,4888,5369,10257
198084001,50 College Rd,Bolivia,NC,28422,575,907,1482
219790001,"Bryan College, 721 Bryan Drive",DAYTON,TN,373216275,622,741,1363
110219001,350 w washington st,Tempe,AZ,85281,432,651,1083
217165001,1150 DOUGLAS PIKE,SMITHFIELD,RI,29171284,2302,1486,3788
211273001,101 N MERION AVE,BRYN MAWR,PA,190102899,70,1620,1690
211291001,1 Dent Drive,LEWISBURG,PA,17837,1793,1875,3668
211307001,275 SWAMP RD,Newtown,PA,189404106,3337,4424,7761
153001001,610 W 4TH ST,STORM LAKE,IA,50588,593,1253,1846
165112001,250 NEW RUTHERFORD AVE,BOSTON,MA,21292925,5251,7271,12522
154800001,901 S HAVERHILL RD,EL DORADO,KS,670423280,3439,4935,8374
211343001,107 college dr,BUTLER,PA,160021203,1314,1991,3305
150163001,4600 SUNSET AVE,INDIANAPOLIS,IN,46208,2166,3329,5495
110246001,3536 Butte Campus Drive,Oroville,CA,959658399,5005,5867,10872
110334001,6500 SOQUEL DR,APTOS,CA,95003,5135,6186,11321
211352001,610 King of Prussia Rd,Radnor,PA,190873698,836,1449,2285
169071001,205 N Mitchell,Cadillac,MI,49601,,,
215114001,200 Manor Ave,Langhorne,PA,190472990,493,650,1143
198118001,2855 Hickory Boulevard,Hudson,NC,28638,1439,2142,3581
183910001,120 Bloomfield AVE,CALDWELL,NJ,70066195,661,1528,2189
110361001,8432 MAGNOLIA AVE,RIVERSIDE,CA,925043297,3692,6794,10486
110370001,5212 BROADWAY,OAKLAND,CA,946181487,677,1128,1805
110316001,1453 Mission St,San Francisco,CA,94103,389,1063,1452
110404001,"1200 E CALIFORNIA BLVD, MC 200-63",PASADENA,CA,91125,1427,806,2233
111081001,24700 W MCBEAN PKY,VALENCIA,CA,913552397,664,842,1506
110413001,60 W OLSEN RD,THOUSAND OAKS,CA,913602787,1818,2565,4383
110422001,1 Grand Avenue,SAN LUIS OBISPO,CA,93407,11351,10662,22013
110529001,3801 W TEMPLE AVE,POMONA,CA,91768,14169,12429,26598
111188001,200 Maritime Academy Drive,Vallejo,CA,945908181,872,174,1046
110486001,9001 STOCKDALE HWY,BAKERSFIELD,CA,933111022,4041,6775,10816
441937001,ONE UNIVERSITY DR,CAMARILLO,CA,930128599,2703,4785,7488
110538001,400 W. 1st  St,Chico,CA,959290150,8071,9507,17578
110547001,1000 E VICTORIA ST,CARSON,CA,907470005,6014,10718,16732
110574001,25800 CARLOS BEE BLVD,HAYWARD,CA,94542,6060,9568,15628
110556001,5200 N BARTON AVE,FRESNO,CA,93740,10090,15047,25137
110565001,800 N STATE COLLEGE BLVD,FULLERTON,CA,928319480,17230,23050,40280
110583001,1250 BELLFLOWER BLVD,LONG BEACH,CA,908400115,15822,21644,37466
110592001,5151 STATE UNIVERSITY DR,LOS ANGELES,CA,90032,11634,16402,28036
409698001,100 CAMPUS CTR,SEASIDE,CA,939558001,2805,4735,7540
110608001,18111 NORDHOFF ST,NORTHRIDGE,CA,913308282,17786,22426,40212
110617001,6000 J Street,Sacramento,CA,958192694,13935,17967,31902
110510001,5500 University Pkwy.,San Bernardino,CA,924072397,7873,12365,20238
366711001,333 S TWIN OAKS VALLEY RD,San Marcos,CA,920960001,5958,10014,15972
110495001,One University Circle,TURLOCK,CA,95382,3483,7094,10577
211361001,250 UNIVERSITY AVE,CALIFORNIA,PA,154191394,3123,4187,7310
169080001,3201 BURTON SE,GRAND RAPIDS,MI,495464442,1716,2016,3732
165167001,500 Rutherford Ave,Charlestown,MA,2129,523,1711,2234
183938001,P.O. Box 200 College Dr,Blackwood,NJ,80120200,3808,5867,9675
206914001,2800 W GORE BLVD,LAWTON,OK,73505,1621,2669,4290
198136001,PO BOX 97,BUIES CREEK,NC,27506,2971,3477,6448
156365001,1 UNIVERSITY DR,CAMPBELLSVILLE,KY,427182799,6852,4618,11470
111434001,4200 FARM HILL BLVD,REDWOOD CITY,CA,940611099,2268,3719,5987
365374001,6505 E HWY 66,EL RENO,OK,730369117,836,660,1496
189705001,2001 MAIN ST,BUFFALO,NY,142081098,1576,1668,3244
165194001,2240 IYANNOUGH RD,WEST BARNSTABLE,MA,26681599,1110,1886,2996
198154001,411 North Front St,Wilmington,NC,28401,3595,4783,8378
413413002,225 S. 6th Street,Minneapolis,MN,55402,7705,29466,37171
129367001,950 Main Street,Hartford,CT,61031211,945,2345,3290
201548001,1 College and Main,COLUMBUS,OH,432092394,1239,1974,3213
238430001,6801 N YATES RD,MILWAUKEE,WI,532173985,671,1477,2148
241377001,CARR 167  KM 21.2 EXT. FOREST HILLS,BAYAMON,PR,9604060,480,717,1197
206923001,1507 S MCKENNA,POTEAU,OK,749535208,617,1283,1900
143613001,2400 Tom L. Wilson Boulevard,GALESBURG,IL,61401,657,1203,1860
173258001,One North College Street,NORTHFIELD,MN,550574001,1039,1058,2097
241331001,Tanca Street 151Old San Juan,San Juan,PR,9023711,297,1462,1759
211431001,3333 Fifth Avenue,Pittsburgh,PA,152133165,349,1727,2076
211440001,5000 FORBES AVE,PITTSBURGH,PA,15213,8115,5914,14029
125532001,8909 FOLSOM BLVD,SACRAMENTO,CA,95826,134,1080,1214
180106001,1601 N BENTON AVE,HELENA,MT,59625,555,780,1335
405872001,1601 WASHINGTON ROAD,WESTMINSTER,MD,211576944,1272,1778,3050
238458001,100 N EAST AVE,WAUKESHA,WI,53186,1134,2218,3352
219806001,1646 S RUSSELL AVE,JEFFERSON CITY,TN,37760,964,1596,2560
198206001,3505 ARENDELL ST,MOREHEAD CITY,NC,285572989,488,902,1390
238476001,2001 ALFORD PARK DR,KENOSHA,WI,531401994,1269,1603,2872
439190001,18345 CAMPUS WAY NE,BOTHELL,WA,980118205,1729,1667,3396
201645001,10900 EUCLID AVE,CLEVELAND,OH,441067004,5780,6110,11890
240505001,125 College Drive,Casper,WY,826014699,1535,2115,3650
230834001,SEMINARY ST.,CASTLETON,VT,5735,975,1221,2196
198215001,2300 W INNES ST,SALISBURY,NC,28144,602,692,1294
198233001,2550 HWY 70 SE,HICKORY,NC,286028302,2046,2564,4610
131283001,"620 Michigan Avenue, NE",WASHINGTON,DC,20064,2697,3259,5956
189839001,197  Franklin St,Auburn,NY,13021,1474,2301,3775
162104001,One Seahawk Drive,North East,MD,219011999,865,1526,2391
211468001,100 COLLEGE DR,ALLENTOWN,PA,18104,192,1404,1596
223773001,3030 NORTH DALLAS AVE,LANCASTER,TX,751343799,3030,5000,8030
201654001,251 N. Main Street,CEDARVILLE,OH,453140601,1909,2241,4150
183974001,400 JEFFERSON ST,HACKETTSTOWN,NJ,7840,606,1196,1802
100760001,1675 Cherokee Rd,Alexander City,AL,35010,766,915,1681
104346001,8470 N OVERFIELD RD,COOLIDGE,AZ,851289778,1873,3171,5044
198251001,1105 KELLY DR,SANFORD,NC,273309059,1923,3267,5190
218858001,506 N GUIGNARD DR,Sumter,SC,291502499,1121,2429,3550
153108001,812 UNIVERSITY,PELLA,IA,50219,551,566,1117
180902001,"3134 West Hwy 34, PO Box 4903",Grand Island,NE,688024903,2587,3767,6354
128771001,1615 STANLEY ST,NEW BRITAIN,CT,6050,5908,5914,11822
483045001,80 COHEN WALKER DR,WARNER ROBINS,GA,31088,2943,5276,8219
173203001,501 WEST COLLEGE DRIVE,BRAINERD,MN,56401,1684,2345,4029
158088001,516 Murray Street,Alexandria,LA,71301,1541,1147,2688
161077001,1250 TURNER ST,Auburn,ME,42106498,1437,1631,3068
445267001,411 Central Methodist Square,Fayette,MO,65248,1236,2627,3863
176947001,411 CENTRAL METHODIST SQUARE,FAYETTE,MO,652481198,540,608,1148
169248001,312  WARRINER HALL,MOUNT PLEASANT,MI,48859,9055,12567,21622
187532001,525 BUENA VISTA SE,ALBUQUERQUE,NM,87106,9840,13713,23553
201672001,1179 UNIVERSITY DR,NEWARK,OH,430551767,1137,2305,3442
208318001,2600 NW COLLEGE WAY,BEND,OR,977035933,2265,2607,4872
211477001,600 Valley Road,SUMMERDALE,PA,170930309,367,680,1047
198260001,1201 Elizabeth Avenue,CHARLOTTE,NC,28204,8459,10365,18824
201690001,"1400 BRUSH ROW RD, PO Box 1004",WILBERFORCE,OH,453841004,837,1262,2099
223816001,6200 West Central Texas Expressway,KILLEEN,TX,765401800,7724,8349,16073
231697001,3506 WARDS RD,LYNCHBURG,VA,245022498,1804,2243,4047
234827001,400 East University Way,Ellensburg,WA,989267501,5828,6514,12342
240514001,2660 Peck Avenue,Riverton,WY,82501,795,1179,1974
234845001,600 Centralia College Blvd.,Centralia,WA,985314099,1132,2035,3167
156408001,600 W WALNUT ST,DANVILLE,KY,404221394,701,733,1434
175315001,3300 CENTURY AVE N,WHITE BEAR LAKE,MN,55110,3928,4963,8891
111887001,11110 ALONDRA BLVD,NORWALK,CA,906506298,10576,11169,21745
111896001,3000 COLLEGE HTS BLVD,RIDGECREST,CA,935557777,2701,3373,6074
111920001,25555 HESPERIAN BLVD,HAYWARD,CA,945454918,6660,7173,13833
180948001,1000 MAIN STREET,CHADRON,NE,69337,1011,1437,2448
111939001,5885 HAVEN AVE,RANCHO CUCAMONGA,CA,917373002,9419,13550,22969
475732001,"5775 Peachtree Dunwoody Road NE, Suite A100",Atlanta,GA,303421556,102,966,1068
454227001,1221 N Swift Rd,Addison,IL,60101,2789,24840,27629
141486001,3140 WAIALAE AVE,HONOLULU,HI,968161578,646,1504,2150
230852001,246 S WILLARD ST,BURLINGTON,VT,5401,2569,1962,4531
364025001,2626 E Pecos Rd,Chandler,AZ,852252449,6934,7794,14728
111948001,One University Dr.,ORANGE,CA,928661011,3805,5803,9608
217688001,9200 UNIVERSITY BLVD,CHARLESTON,SC,294068087,1286,2128,3414
102845001,2221 E NORTHERN LIGHTS BLVD STE 120,ANCHORAGE,AK,99508,702,2151,2853
128780001,55 PAUL J MANAFORT DR,NEW BRITAIN,CT,6053,518,1123,1641
211556001,WOODLAND RD,PITTSBURGH,PA,15232,547,1789,2336
140331001,980 S COBB DR,MARIETTA,GA,300603398,4347,6136,10483
101028001,2602 COLLEGE DR,PHENIX CITY,AL,36869,610,958,1568
219824001,4501 AMNICOLA HWY,CHATTANOOGA,TN,374061097,3275,4966,8241
208390001,4000 LANCASTER DR NE,SALEM,OR,97305,4420,5731,10151
162168001,1000 COLLEGE CIRCLE,WYE MILLS,MD,216790008,731,1350,2081
211583001,9601 GERMANTOWN AVE,PHILADELPHIA,PA,191182693,591,1203,1794
144005001,9501 S. King Drive Suite ADM #313,CHICAGO,IL,606281598,963,2001,2964
133021001,3094 INDIAN CIRCLE,MARIANNA,FL,324462053,815,1266,2081
240116001,620 W Clairemont Ave,Eau Claire,WI,547016120,3527,4118,7645
198303001,One University Place,MURFREESBORO,NC,27855,681,718,1399
219833001,650 E PARKWAY S,MEMPHIS,TN,38104,982,1052,2034
260947001,400 E Gregory St,Mt Prospect,IL,600562522,,,
231712001,1 Avenue of the Arts,NEWPORT NEWS,VA,236062998,2182,2775,4957
201928001,3520 Central Parkway,Cincinnati,OH,452232690,3618,4587,8205
223898001,101 College Heights,Cisco,TX,76437,1267,2107,3374
217864001,171 MOULTRIE STREET,CHARLESTON,SC,29409,2992,771,3763
112172001,1000 W Foothill Blvd.,Glendora,CA,917411899,6011,7125,13136
112190001,50 Frida Khalo way,San Francisco,CA,941121898,12623,14385,27008
144500001,180 N. Wabash,Chicago,IL,60601,,,
144209001,30 E LAKE ST,CHICAGO,IL,606012449,3671,4972,8643
144184001,1145 W WILSON AVE,CHICAGO,IL,606405691,3189,4484,7673
144157001,6301 S. Halsted St.,CHICAGO,IL,60621,1273,1863,3136
144166001,1900 W Jackson Blvd,CHICAGO,IL,606123197,1865,5239,7104
144175001,10001 S. Woodlawn Ave.,Chicago,IL,606281696,975,1688,2663
144193001,7500 S PULASKI RD,CHICAGO,IL,606521299,3003,3939,6942
144218001,4300 N NARRAGANSETT,CHICAGO,IL,606341591,4308,5469,9777
234915001,"150 - 120th Avenue, Suite 100",Bellevue,WA,98005,863,1250,2113
208406001,19600 MOLALLA AVE,OREGON CITY,OR,97045,3162,2902,6064
217873001,400 MAGNOLIA STREET,ORANGEBURG,SC,291154498,686,1486,2172
112251001,150 E TENTH ST,CLAREMONT,CA,917116160,806,1076,1882
112260001,500 E 9TH ST,CLAREMONT,CA,917116400,692,635,1327
223922001,1122 College Drive / P.O. Box 968,CLARENDON,TX,792260968,877,967,1844
211644001,840 WOOD ST,CLARION,PA,16214,1474,3390,4864
138947001,"223 James P. Brawley Drive, SW",Atlanta,GA,303144391,1015,2896,3911
234933001,1933 Fort Vancouver Way,VANCOUVER,WA,986633598,4183,5695,9878
201973001,570 E LEFFEL LN,SPRINGFIELD,OH,455050570,1953,3751,5704
165334001,950 MAIN ST,WORCESTER,MA,16101477,1264,1858,3122
153126001,1550 CLARKE DR,DUBUQUE,IA,520013198,365,639,1004
180832001,101 S 42ND ST,OMAHA,NE,681312739,165,997,1162
190044001,8 Clarkson Ave.,POTSDAM,NY,136995557,2815,1459,4274
139311001,2000 Clayton State Blvd.,MORROW,GA,302600285,2131,4907,7038
217882001,201 Sikes Hall,Clemson,SC,29634,12689,12262,24951
198321001,137 S POST RD,SHELBY,NC,28152,917,1634,2551
219879001,3535 ADKISSON DRIVE,CLEVELAND,TN,373203570,1391,1873,3264
202134001,2121 EUCLID AVE,CLEVELAND,OH,44115,7149,8920,16069
190053001,136 CLINTON POINT DR,PLATTSBURGH,NY,12901,589,764,1353
154907001,"2221 Campus Drive, Box 1002",Concordia,KS,669011002,772,1067,1839
234951001,4500 STEILACOOM BLVD SW,LAKEWOOD,WA,984994004,1404,2501,3905
187639001,417 Schepps Blvd,Clovis,NM,881018381,952,2155,3107
175519001,3240 FRIARS POINT RD,CLARKSDALE,MS,38614,759,1136,1895
101161001,1900 US Hwy 31 South,Bay Minette,AL,365072698,3098,4321,7419
223320001,3800 CHARCO RD,BEEVILLE,TX,78102,1861,2753,4614
198330001,444 WESTERN BLVD,JACKSONVILLE,NC,285466877,1516,2348,3864
218724001,755 HWY 544,CONWAY,SC,29526,4820,5821,10641
485458001,1701 Carswell Ave,Waycross,GA,31503,1350,2117,3467
112385002,12901 Euclid Street,Garden Grove,CA,92840,6368,4609,10977
104425001,4190 W. Highway 80,Douglas,AZ,856079724,1644,2026,3670
404426001,3000 North Fourth Street,Flagstaff,AZ,860041825,1751,1968,3719
153144001,1220 FIRST AVE NE,CEDAR RAPIDS,IA,524025092,630,792,1422
154925001,400 W 11TH ST,COFFEYVILLE,KS,673375064,1017,881,1898
217907001,300 E COLLEGE AVE,HARTSVILLE,SC,29950,556,724,1280
161086001,MAYFLOWER HILL DRIVE,WATERVILLE,ME,4901,951,1049,2000
154934001,1255 S RANGE,COLBY,KS,67701,443,969,1412
241720001,180 Jose Oliver St Tres Monjitas Ind. Park,San Juan,PR,918,481,693,1174
190099001,13 OAK DR,HAMILTON,NY,133461398,1329,1640,2969
169442001,201 E KIRBY,DETROIT,MI,48202,627,858,1485
108667001,555 Ralph Appezzato Memorial Parkway,ALAMEDA,CA,94501,2711,3678,6389
417318001,"8700 West Flagler Street,Suite 420",Miami,FL,33174,,,
132851001,3001 SW COLLEGE RD,OCALA,FL,344744415,2560,4260,6820
217819001,66 George St,Charleston,SC,294240001,3756,7027,10783
139250001,ONE COLLEGE DRIVE,BRUNSWICK,GA,315203644,1128,2418,3546
144865001,425 Fawell Blvd.,Glen Ellyn,IL,601376599,11574,13326,24900
142179001,1600 S 25TH E,IDAHO FALLS,ID,834045788,464,824,1288
146472001,19351 W WASHINGTON ST.,GRAYSLAKE,IL,600301198,6401,7792,14193
118347001,835 COLLEGE AVE,KENTFIELD,CA,949042590,2123,2903,5026
243638001,"P.O. Box 159, Kolonia",Pohnpei,FM,969410159,868,1063,1931
193399001,6301 RIVERDALE AVE,Bronx,NY,104711093,520,1341,1861
167394001,291 SPRINGFIELD ST,CHICOPEE,MA,10132839,370,1161,1531
174747001,37 SOUTH COLLEGE AVENUE,SAINT JOSEPH,MN,563742099,0,1782,1782
186618001,2 Convent Road,Morristown,NJ,79606989,253,933,1186
181604001,7000 Mercy Road,OMAHA,NE,681062377,31,1137,1168
122791001,1700 W HILLSDALE BLVD,SAN MATEO,CA,944023784,4549,4375,8924
142559001,315 Falls Ave.,TWIN FALLS,ID,833011238,2497,4409,6906
162122001,PO Box 910,La Plata,MD,206460910,2736,4146,6882
182005001,6375 West Charleston Blvd.,Las Vegas,NV,89146,14701,19468,34169
190558001,2800 Victory Boulevard,Staten Island,NY,10314,5931,7316,13247
197814001,1208 N Road Street,Elizabeth City,NC,279062327,902,1655,2557
111461001,26455 ROCKWELL CANYON RD,Valencia,CA,913551899,11280,9570,20850
113573001,43-500 MONTEREY AVE,PALM DESERT,CA,92260,5027,6385,11412
166124001,ONE COLLEGE STREET,WORCESTER,MA,16102395,1433,1506,2939
226408001,1200 AMBURN RD,TEXAS CITY,TX,775912499,1929,2744,4673
376695001,P.O. Box 1258,Majuro,MH,96960,571,548,1119
107521001,ONE COLLEGE CIR,MALVERN,AR,72104,552,705,1257
178697001,100 Opportunity Ave,Point Lookout,MO,657260017,700,865,1565
121707001,7351 Tompkins Hill Rd.,Eureka,CA,955019302,2121,2451,4572
123217001,915 S MOONEY BLVD,VISALIA,CA,932772214,5333,7224,12557
123484001,800 COLLEGE AVE,WEED,CA,960942899,765,912,1677
455114001,P.O.Box 3010,Nampa,ID,83653,4380,5897,10277
231624001,PO Box 8795,WILLIAMSBURG,VA,231878795,3852,4965,8817
247834001,2200 W UNIVERSITY DR,MCKINNEY,TX,75070,14897,18771,33668
126669001,8787 W. Alameda,Lakewood,CO,80226,2550,5075,7625
126678001,14 E CACHE LA POUDRE,COLORADO SPRINGS,CO,80903,944,1200,2144
127556001,1100 North Avenue,GRAND JUNCTION,CO,815013122,4386,5106,9492
126711001,802 Grand Ave.,GLENWOOD SPRINGS,CO,81601,2428,3260,5688
126748001,500 KENNEDY DR,RANGELY,CO,81648,455,699,1154
126775001,1500 ILLINOIS ST,GOLDEN,CO,80401,4411,1914,6325
126818001,102 Administration Building,Fort Collins,CO,805230100,15890,17588,33478
128106001,2200 BONFORTE BLVD,PUEBLO,CO,810014901,2581,4155,6736
126827001,4435 N Chestnut Street,Colorado Springs,CO,809073812,9662,16522,26184
234979001,2600 N 20TH AVE,PASCO,WA,993013379,3219,3815,7034
241304001,PO Box 8517,Caguas,PR,726,474,682,1156
112561001,11600 COLUMBIA COLLEGE DR,SONORA,CA,95370,1116,1380,2496
144281001,600 SOUTH MICHIGAN,CHICAGO,IL,606051996,2870,3955,6825
217925001,7435 MONTICELLO RD,COLUMBIA,SC,292303122,548,500,1048
450933001,21982 University Lane,Orange Beach,AL,36561,12731,8373,21104
219888001,1665 HAMPSHIRE PIKE,COLUMBIA,TN,38401,2489,3732,6221
190150001,116 ST AND BROADWAY,NEW YORK,NY,10027,14803,16274,31077
190169001,4400 RTE 23,HUDSON,NY,125349543,592,992,1584
202170001,60 Cleveland Ave.,COLUMBUS,OH,43215,329,765,1094
202222001,550 East Spring Street,Columbus,OH,43215,12776,14567,27343
139366001,4225 UNIVERSITY AVE,COLUMBUS,GA,319075645,3238,4838,8076
139357001,928 Manchester Expressway,Columbus,GA,319046572,1127,2174,3301
210605001,801 Ridge Avenue,Pittsburgh,PA,15212,7339,8747,16086
126863001,16000 E CentreTech Pkwy.,Aurora,CO,800119036,3349,4632,7981
434672001,800 S. Rolling Road,Catonsville,MD,212285317,7170,11660,18830
211079001,ONE CAMPUS DR,MONACA,PA,150612588,925,1329,2254
126942001,1111 W. Colfax Ave.,DENVER,CO,802042026,3211,4676,7887
215239001,1700 SPRING GARDEN ST,PHILADELPHIA,PA,191303991,6001,10671,16672
217475001,400 EAST AVE,WARWICK,RI,28861807,6047,8492,14539
230861001,PO Box 489,Montpelier,VT,56010489,1741,3637,5378
237330001,VERMILLION STREET,ATHENS,WV,24712,758,1282,2040
219903001,5100 POPLAR AVE STE 132,MEMPHIS,TN,381370132,142,1252,1394
173300001,901 S 8TH ST,MOORHEAD,MN,56562,877,1252,2129
190248001,171 WHITE PLAINS RD,BRONXVILLE,NY,107081998,347,1390,1737
224004001,11400 Concordia University Drive,AUSTIN,TX,78726,845,1723,2568
169363001,4090 Geddes Rd,Ann Arbor,MI,48105,518,679,1197
144351001,7400 AUGUSTA,RIVER FOREST,IL,603051499,2051,3954,6005
112075001,1530 Concordia West,Irvine,CA,926123299,1644,2518,4162
180984001,800 N COLUMBIA,SEWARD,NE,68434,989,1435,2424
208488001,2811 NE Holman Street,Portland,OR,972116099,1290,4052,5342
173328001,1282 Concordia Avenue,SAINT PAUL,MN,551045494,1840,3214,5054
238616001,12800 N LAKE SHORE DR,Mequon,WI,530972402,2052,4322,6374
128902001,270 MOHEGAN AVE,NEW LONDON,CT,6320,714,1130,1844
206996001,700 College Rd.,WARNER,OK,74469,694,1396,2090
112826001,2600 MISSION BELL DR,SAN PABLO,CA,94806,2828,4365,7193
217961001,580 E MAIN ST,SPARTANBURG,SC,293020006,77,1303,1380
175573001,1001 Copiah Lincoln Lane,Wesson,MS,39191,1138,1956,3094
395362001,6162 Rotary Way,Joshua Tree,CA,92252,614,1134,1748
162283001,2500 W NORTH AVE,BALTIMORE,MD,212163698,587,2151,2738
210331001,5000 DEER PARK DR SE,SALEM,OR,973179392,477,706,1183
153162001,600 FIRST ST SW,Mount Vernon,IA,523141098,535,493,1028
190415001,G-2 Barton Hall Cornell University,ITHACA,NY,148531701,11698,11902,23600
170037001,1001 E BELTLINE AVE NE,GRAND RAPIDS,MI,495255897,840,1291,2131
190442001,1 ACADEMIC DR,CORNING,NY,14830,1472,1952,3424
106795001,183 College Drive,DE QUEEN,AR,71832,565,953,1518
113096001,8401 CENTER PKY,SACRAMENTO,CA,958235799,6228,7965,14193
184180001,214 CENTER GROVE RD,RANDOLPH,NJ,78692086,4056,3500,7556
139393001,14049 Scenic Highway,LOOKOUT MOUNTAIN,GA,307504164,501,545,1046
154952001,125 S SECOND ST,ARKANSAS CITY,KS,67005,1091,1573,2664
113111001,11711 SAND CANYON RD,YUCAIPA,CA,923991799,2939,3613,6552
198367001,800 College Court,New Bern,NC,28562,1260,1743,3003
181002001,2500 California Plaza,Omaha,NE,68178,3653,5257,8910
177135001,601 LACLEDE AVE,NEOSHO,MO,64850,1695,2826,4521
174862001,8700 College View Drive,SAINT BONIFACIUS,MN,553759001,703,807,1510
113193001,HIGHWAY 1,SAN LUIS OBISPO,CA,934038106,5418,5606,11024
190503001,1946 Campus Drive,Hyde Park,NY,12538,1464,1526,2990
177144001,1 COLLEGE HILL,CANTON,MO,634351299,534,534,1068
184205001,3322 College Drive,Vineland,NJ,8360,998,1936,2934
219949001,1  CUMBERLAND SQUARE,LEBANON,TN,370873554,1037,1368,2405
190512001,17 LEXINGTON AVE,NEW YORK,NY,10010,9258,8771,18029
190521001,199 CHAMBERS ST,NEW YORK,NY,100071097,11233,15273,26506
190530001,2155 UNIVERSITY AVENUE,BRONX,NY,104533102,4641,5878,10519
190549001,2900 BEDFORD AVE,BROOKLYN,NY,112102889,7512,10649,18161
190567001,160 CONVENT AVE,NEW YORK,NY,10031,7440,8603,16043
190576001,365 FIFTH AVE,NEW YORK,NY,100164309,2862,5179,8041
190585001,500 GRAND CONCOURSE,BRONX,NY,10451,2424,4907,7331
190594001,695 Park Avenue,New York,NY,10065,7517,15685,23202
190600001,524 W 59th Street,NEW YORK,NY,10019,6602,8792,15394
190619001,2001 ORIENTAL BOULEVARD,BROOKLYN,NY,11235,6592,8459,15051
190628001,31-10 THOMSON AVE,LONG ISLAND CITY,NY,11101,8125,11175,19300
190637001,250 BEDFORD PARK BLVD WEST,BRONX,NY,104681589,4720,10067,14787
190646001,1650 BEDFORD AVE,BROOKLYN,NY,112252010,2045,4593,6638
190655001,300 JAY ST,BROOKLYN,NY,11201,9664,7605,17269
190664001,65 30 Kissena Blvd,Flushing,NY,113670904,8542,11204,19746
190673001,222-05 56th Ave.,Bayside,NY,113641497,7261,8150,15411
190691001,94-20 Guy R. Brewer Blvd,Jamaica,NY,11451,3070,5623,8693
165529001,1071 BLUE HILL AVE,MILTON,MA,21862395,1076,1504,2580
202356001,2900 Community College Ave.,Cleveland,OH,44115,9337,14103,23440
113218001,900 RANCHO SAN DIEGO PKWY,EL CAJON,CA,92019,3917,4907,8824
113236001,9200 VALLEY VIEW,CYPRESS,CA,906305897,6835,8959,15794
190716001,320 PORTER AVE,BUFFALO,NY,142011084,835,2210,3045
190725001,4380 Main Street,AMHERST,NY,142263592,675,1899,2574
173416001,1300 E 145TH ST,ROSEMOUNT,MN,550682999,1538,985,2523
219082001,820 N WASHINGTON,MADISON,SD,57042,2042,1340,3382
219091001,1200 W. University Ave.,Mitchell,SD,57301,428,596,1024
224226001,3000 MOUNTAIN CREEK PARKWAY,DALLAS,TX,752119299,1888,2878,4766
224305001,3909 SWISS AVE,DALLAS,TX,75204,1443,879,2322
139463001,650 COLLEGE DRIVE,DALTON,GA,307203797,2072,3046,5118
144564001,2000 E MAIN ST,DANVILLE,IL,618325118,1107,1513,2620
231882001,1008 S MAIN ST,DANVILLE,VA,245414004,1258,1570,2828
182670001,North Main Street,HANOVER,NH,37553529,3385,3187,6572
169479001,6191 Kraft Avenue S.E.,Grand Rapids,MI,49512,2982,3764,6746
198385001,102 North Main Street,Davidson,NC,28035,956,887,1843
198376001,P.O. Box 1287,Lexington,NC,27360,1343,2311,3654
230162001,550 E 300 S,KAYSVILLE,UT,840372699,1891,1271,3162
133386001,1200 West International Speedway Blvd.,Daytona Beach,FL,32114,5355,8382,13737
113333001,21250 STEVENS CREEK BLVD,CUPERTINO,CA,95014,9908,9574,19482
165574001,99 Main Street,Franklin,MA,20381941,634,686,1320
224350001,101 Baldwin Blvd.,Corpus Christi,TX,784043897,4916,6951,11867
211927001,901 S MEDIA LINE RD,MEDIA,PA,190631094,4551,6763,11314
130934001,1200 N. Dupont Highway,Dover,DE,199012202,1568,3018,4586
130907001,100 CAMPUS DRIVE,DOVER,DE,19901,4994,8901,13895
211981001,700 E BUTLER AVE,DOYLESTOWN,PA,189012697,961,1467,2428
158662001,615 City Park Avenue,New Orleans,LA,701194399,4531,9727,14258
169521001,1961 Delta Road,UNIVERSITY CENTER,MI,48710,3415,4665,8080
175616001,1003 W Sunflower Rd,Cleveland,MS,38733,1466,2249,3715
202523001,100 West Loop,GRANVILLE,OH,43023,1093,1301,2394
144740001,2345 N. Sheffield,CHICAGO,IL,60614,10448,11989,22437
150400001,313 S LOCUST ST,GREENCASTLE,IN,461351772,1021,1135,2156
153214001,2006 South Ankeny Blvd.,Ankeny,IA,500238995,10475,12999,23474
154156001,3200 GRAND AVE,DES MOINES,IA,503124198,778,771,1549
210739001,2755 Station Ave,Center Valley,PA,180349568,1229,2209,3438
482413001,"180 Madison Ave., Ste. 1200",New York,NY,10016,858,613,1471
482431001,"2970 E. Inland Empire Blvd., Ste. 100",Ontario,CA,91764,1489,1010,2499
482468001,"1 W Court Sq., Ste. 600",Decatur,GA,30030,508,673,1181
482477001,3300 N CAMPBELL AVE,CHICAGO,IL,60618,6277,11087,17364
113634001,321 GOLF CLUB RD,PLEASANT HILL,CA,94523,9812,10459,20271
212009001,P.O. Box 1773,CARLISLE,PA,170132896,1007,1392,2399
200059001,291 Campus Drive,Dickinson,ND,586014896,555,837,1392
158802001,2601 GENTILLY BLVD,NEW ORLEANS,LA,70122,316,993,1309
105297001,"Route 12, NHC Bldg. 1st Floor, Room 113",TSAILE,AZ,86556,490,1029,1519
230171001,225 S 700 E,SAINT GEORGE,UT,847703876,4256,5694,9950
181020001,1014 BOSWELL,CRETE,NE,68333,556,452,1008
448284001,303 N 52nd St,Lincoln,NE,68504,466,1143,1609
154998001,2501 N 14TH AVE,DODGE CITY,KS,678012399,728,820,1548
190761001,470 Western Highway,Orangeburg,NY,109621210,632,1324,1956
148496001,7900 W Division St.,River Forest,IL,60305,860,2130,2990
113698001,50 ACACIA AVE,SAN RAFAEL,CA,949012298,461,1318,1779
153250001,498 4TH AVE NE,SIOUX CENTER,IA,512501697,827,737,1564
153269001,2507 UNIVERSITY AVE,DES MOINES,IA,503114505,1865,3004,4869
184348001,36 MADISON AVE,MADISON,NJ,7940,975,1288,2263
212054001,3141 CHESTNUT ST,PHILADELPHIA,PA,19104,11293,13341,24634
177214001,900 N. Benton Avenue,Springfield,MO,65802,690,1040,1730
198419001,207 ALLEN BLDG. BOX 90001,DURHAM,NC,27708,8137,8469,16606
175227001,818 DUNWOODY BLVD,MINNEAPOLIS,MN,554031192,1088,228,1316
212106001,ADMINISTRATION BLDG 600 FORBES AVE,PITTSBURGH,PA,15282,3368,5906,9274
198455001,1637 East Lawson Street,Durham,NC,27703,2061,3373,5434
190840001,53 PENDELL RD,POUGHKEEPSIE,NY,126013415,3893,4689,8582
220057001,1510 Lake Road,Dyersburg,TN,380242411,957,2020,2977
150455001,801 National Road West,Richmond,IN,473744095,505,599,1104
106883001,1700 NEWCASTLE RD,FORREST CITY,AR,72335,409,742,1151
198464001,EAST FIFTH STREET,GREENVILLE,NC,278584353,11836,16882,28718
177250001,1964 Prairie Dell Rd.,Union,MO,63084,1043,1586,2629
175643001,15738 Hwy 15 P.O. Box 129,DECATUR,MS,393270129,1029,1574,2603
207041001,1100 E. 14th Street,ADA,OK,748206899,1378,2198,3576
139621001,131 COLLEGE CIRCLE,SWAINSBORO,GA,30401,1170,1772,2942
113856001,1301 Avenida Cesar Chavez,Monterey Park,CA,917546099,17899,17504,35403
175652001,1512 Kemper Street,SCOOBA,MS,393580158,1720,2280,4000
212115001,200 PROSPECT ST,EAST STROUDSBURG,PA,183012999,2717,3695,6412
220075001,1276 Gilbreath Drive,Johnson City,TN,376140000,5822,8495,14317
224527001,1 Tiger Drive,Marshall,TX,756701498,730,883,1613
104577001,615 N. Stadium Avenue,Thatcher,AZ,855520769,2676,3364,6040
129215001,83 WINDHAM ST,WILLIMANTIC,CT,6226,2150,3058,5208
132693001,1519 CLEARLAKE RD,COCOA,FL,32922,6329,9491,15820
203331001,4000 SUNSET BLVD,STEUBENVILLE,OH,439523598,3575,10365,13940
144892001,600 LINCOLN AVE,CHARLESTON,IL,61920,3064,4462,7526
153311001,101 West Third Street,Davenport,IA,528011221,3329,4442,7771
156620001,521 Lancaster Avenue,Richmond,KY,404753102,6427,9388,15815
161138001,354 HOGAN RD,BANGOR,ME,4401,1152,1244,2396
232043001,1200 PARK RD,HARRISONBURG,VA,228022462,497,947,1444
169798001,1200 Oakwood,YPSILANTI,MI,48197,7420,11703,19123
187648001,"ENMU Station #1, 1500 South Avenue K",Portales,NM,88130,2474,3531,6005
187666001,52 UNIVERSITY BLVD,ROSWELL,NM,882030000,1019,1408,2427
207050001,1301 W MAIN ST,WILBURTON,OK,74578,509,1032,1541
208646001,ONE UNIVERSITY BLVD,LA GRANDE,OR,97850,1192,1786,2978
212133001,1300 EAGLE RD,SAINT DAVIDS,PA,190873696,1022,2234,3256
231970001,721 Fairfax Ave.,NORFOLK,VA,235071696,535,768,1303
235097001,526 5th Street,CHENEY,WA,990042496,5598,7035,12633
240596001,3200 WEST C ST,TORRINGTON,WY,82240,626,836,1462
224572001,3737 MOTLEY DR,MESQUITE,TX,751502099,6778,9991,16769
133492001,4200 54TH AVE S,SAINT PETERSBURG,FL,337114700,673,1333,2006
248934001,5555 GREENWICH RD STE 300,VIRGINIA BEACH,VA,23462,5452,7495,12947
198491001,2009 W WILSON ST,TARBORO,NC,27886,468,1544,2012
238661001,1000 EDGEWOOD COLLEGE DRIVE,MADISON,WI,537111997,586,1604,2190
376321001,Calle Genova Num 8 ESQ 5 URB Caguas Norte,Caguas,PR,7269120,509,1729,2238
212160001,219 Meadville Street,Edinboro,PA,164440001,1735,3099,4834
202648001,1973 EDISON DR,PIQUA,OH,453569239,1460,2216,3676
235103001,20000 68TH AVE W,LYNNWOOD,WA,980365999,3682,4359,8041
243832001,PONCE DE LEON AVE. #560,Hato Rey,PR,9192303,671,1425,2096
241836001,Betances 49,San Sebastian,PR,685,381,724,1105
442806001,2265 KRAFT DR,BLACKSBURG,VA,24060,972,1033,2005
133526001,1658 KINGS RD,JACKSONVILLE,FL,322096169,1427,1479,2906
112686001,1111 East Artesia Blvd.,Compton,CA,902215393,2526,4520,7046
113980001,16007 Crenshaw Boulevard,Torrance,CA,905060001,12180,12640,24820
224615001,801 Main,DALLAS,TX,752023604,3989,7740,11729
224642001,919 Hunter Drive,El Paso,TX,799151908,12200,16619,28819
144944001,1700 SPARTAN DR,ELGIN,IL,601237193,4395,5172,9567
198507001,1704 WEEKSVILLE RD,ELIZABETH CITY,NC,27909,707,970,1677
212197001,ONE ALPHA DR,ELIZABETHTOWN,PA,170222298,636,1051,1687
156648001,600 COLLEGE STREET RD,ELIZABETHTOWN,KY,427013081,3048,3351,6399
144962001,190 S Prospect Avenue,Elmhurst,IL,601263096,1319,2107,3426
198516001,100 Campus Drive,Elon,NC,272442010,2787,4204,6991
133553001,1 AEROSPACE BLVD.,DAYTONA BEACH,FL,321143900,5079,1534,6613
104586001,3700 Willow Creek Road,Prescott,AZ,863013720,2075,701,2776
426314003,"1900 Wyoming Boulevard. SE, Room 202",Kirtland AFB,NM,87117,11775,2393,14168
165662001,120 Boylston Street,Boston,MA,21164624,1730,2843,4573
127158001,1860 Lincoln St.,DENVER,CO,80203,4398,668,5066
232025001,30461 Garnand Drive,Emory,VA,243270947,543,703,1246
139658001,201 Dowman Drive,ATLANTA,GA,30322,5854,8604,14458
155025001,1 Kellog Circle,EMPORIA,KS,668015087,1952,3844,5796
165699001,376 HALE ST,BEVERLY,MA,1915,1631,3163,4794
101143001,600 PLAZA DR,ENTERPRISE,AL,363301300,839,866,1705
191083001,121 ELLICOTT ST,BUFFALO,NY,14203,5108,5421,10529
184481001,303 UNIVERSITY AVE,NEWARK,NJ,71021798,3169,4345,7514
384333001,3000 N DYSART RD,Avondale,AZ,853921000,4004,5972,9976
177339001,1111 N GLENSTONE AVE.,SPRINGFIELD,MO,658022191,976,1122,2098
235149001,2000 Tower Street,Everett,WA,982011390,3597,4360,7957
385619001,"5002 T-REX AVENUE, SUITE 100",BOCA RATON,FL,334310000,1131,1131,2262
114266001,3095 YERBA BUENA RD,SAN JOSE,CA,951351598,4303,5295,9598
196680001,7 Columbia Circle,Albany,NY,122035159,15678,14330,30008
129242001,1073 NORTH BENSON RD,FAIRFIELD,CT,68245195,2005,3268,5273
184694001,285 MADISON AVE,MADISON,NJ,7940,1441,2042,3483
184603001,1000 RIVER RD,TEANECK,NJ,7666,3078,4793,7871
237367001,1201 Locust  Ave,Fairmont,WV,26554,1664,2283,3947
196042001,2350 Broadhollow Road,FARMINGDALE,NY,117351021,5659,4311,9970
191126001,227 West 27th Street,New York,NY,100015992,1455,7312,8767
101189001,5345 ATLANTA HWY,MONTGOMERY,AL,361093378,1269,1909,3178
198543001,1200 MURCHISON RD,FAYETTEVILLE,NC,283014298,2058,4260,6318
198534001,2201 HULL RD,FAYETTEVILLE,NC,283030236,4739,6795,11534
114433001,570 GOLDEN EAGLE AVE,QUINCY,CA,95971,1083,1133,2216
184612001,262 South Main St,Lodi,NJ,7644,566,1438,2004
169910001,901 S State St,Big Rapids,MI,493072251,6120,7130,13250
232089001,215 Ferrum Mountain Road,FERRUM,VA,240889000,630,494,1124
114354001,919 S Grand Ave,Los Angeles,CA,900151421,309,1912,2221
191199001,3325 Marvin Sands Dr.,CANANDAIGUA,NY,144248395,2579,3365,5944
165802001,118 BEACON ST,BOSTON,MA,2116,475,1187,1662
165820001,160 PEARL ST,FITCHBURG,MA,14202697,2770,4429,7199
133711001,74 KING STREET,SAINT AUGUSTINE,FL,320841027,873,1735,2608
180197001,777 GRANDVIEW DR,KALISPELL,MT,59901,1035,1316,2351
160481004,1407 HWY 311,Schriever,LA,70395,722,1439,2161
155052001,3301 W 18TH Avenue,EMPORIA,KS,66801,709,716,1425
218025001,2715 W. Lucas Street,Florence,SC,295010548,1443,2739,4182
133650001,Lee Hall    1601 S. Martin Luther King Jr. Blvd,Tallahassee,FL,32307,3560,6461,10021
133669001,777 GLADES RD,BOCA RATON,FL,334310991,12795,16977,29772
135160001,149 S.E. College Pl,LAKE CITY,FL,320258703,1193,2192,3385
433660001,10501 FGCU BLVD S,Fort Myers,FL,339656565,6488,8543,15031
133881001,150 W UNIVERSITY BLVD,MELBOURNE,FL,329016975,4122,2149,6271
133951001,11200 S.W. 8 Street,MIAMI,FL,331990001,24852,33090,57942
133979001,15800 NW 42 AVE,Miami Gardens,FL,330546199,465,724,1189
408844001,4425  W 20TH AVE,HIALEAH,FL,33012,1119,2925,4044
482936001,4700 Research Way,Lakeland,FL,338058531,1235,190,1425
134079001,111 LAKE HOLLINGSWORTH DR,LAKELAND,FL,338015698,1060,2094,3154
133508001,8099 College Parkway,Fort Myers,FL,33919,6067,10489,16556
133702001,101 W STATE ST,JACKSONVILLE,FL,32202,8794,14619,23413
134097001,211 WESTCOTT BLDG,TALLAHASSEE,FL,323061037,17772,23233,41005
134112001,12900 Challenger Parkway,Orlando,FL,32826,1250,2700,3950
444219001,10 College Parkway,FOLSOM,CA,956306798,3782,4793,8575
380368001,2101 14TH ST,CLOQUET,MN,557205581,857,1125,1982
177418001,6800 WYDOWN BLVD,SAINT LOUIS,MO,631053098,442,848,1290
114716001,12345 EL MONTE RD,LOS ALTOS HILLS,CA,94022,7524,7208,14732
191241001,441 E FORDHAM RD,BRONX,NY,10458,6527,9988,16515
198552001,2100 SILAS CREEK PKY,Winston-Salem,NC,271035197,3141,4638,7779
155061001,600 PARK ST,HAYS,KS,676014099,6160,9363,15523
127185001,1000 RIM DRIVE,DURANGO,CO,813013999,1596,1723,3319
135267001,3800 MICHIGAN AVE,FORT MYERS,FL,33916,856,236,1092
155098001,2108 S HORTON,FORT SCOTT,KS,66701,920,948,1868
139719001,1005 STATE UNIVERSITY DRIVE,FORT VALLEY,GA,310304313,1049,1727,2776
238722001,1825 N BLUEMOUND DR,APPLETON,WI,549122277,6409,5300,11709
165866001,100 STATE ST,FRAMINGHAM,MA,17019101,2003,3562,5565
218061001,4822 EAST PALMETTO STREET,FLORENCE,SC,295020547,1155,2785,3940
245999001,12777 N ROCKWELL AVE,OKLAHOMA CITY,OK,731422789,970,975,1945
160074001,5414 Brittany Dr.,BATON ROUGE,LA,70808,272,1096,1368
205957001,1235 UNIVERSITY BLVD,STEUBENVILLE,OH,439521763,1229,1799,3028
224891001,1301 W. Roosevelt St.,BORGER,TX,790085118,676,808,1484
212577001,415 Harrisburg Ave.,LANCASTER,PA,176043003,1041,1268,2309
182795001,40 University Drive,RINDGE,NH,34610060,954,1224,2178
202806001,201 S GRANT AVE,COLUMBUS,OH,432155399,2192,2778,4970
485351001,5410 N. 20th Street,Tampa,FL,33610,,,
162557001,7932 OPOSSUMTOWN PK,FREDERICK,MD,21702,2575,3425,6000
220215001,158 E MAIN ST,HENDERSON,TN,383402399,824,1213,2037
114789001,1101 E. UNIVERSITY AVE,FRESNO,CA,93741,11088,13278,24366
114813001,1717 S Chestnut Ave,Fresno,CA,93702,1174,3118,4292
155089001,2100 W. UNIVERSITY  AVE.,WICHITA,KS,67213,764,1162,1926
127200001,3645 W. 112th Avenue,Westminster,CO,800312199,8217,10663,18880
403469001,2 FRONTIER DR,FAIRFIELD,IL,62837,632,1299,1931
156727001,195 School Street,HYDEN,KY,41749,126,2014,2140
162584001,101 Braddock Road,FROSTBURG,MD,215321099,2455,2840,5295
134237001,3300 UNIVERSITY BLVD,WINTER PARK,FL,327927429,14217,5953,20170
114840001,135 N OAKLAND AVE,PASADENA,CA,91182,1344,1017,2361
114859001,321 E CHAPMAN AVE,FULLERTON,CA,92832,10704,11940,22644
191302001,2805 ST HWY 67,JOHNSTOWN,NY,120953790,1040,1411,2451
218070001,3300 POINSETT HWY,GREENVILLE,SC,296136162,1151,1796,2947
101240001,PO Box 227,GADSDEN,AL,359020227,1897,2839,4736
156471001,1031 Zorn Avenue,Louisville,KY,40207,184,1770,1954
406033001,"7411 John Smith Drive, Suite 1400",San Antonio,TX,78229,240,1270,1510
406024001,10200 Dr Martin Luther King Jr Street N,SAINT PETERSBURG,FL,33716,179,1124,1303
131450001,800 FLORIDA AVE NE,WASHINGTON,DC,200023695,638,919,1557
224961001,4015 AVE Q,GALVESTON,TX,775507496,930,1499,2429
212601001,109 University Square,ERIE,PA,165410001,1699,2592,4291
155104001,801 CAMPUS DRIVE,GARDEN CITY,KS,67846,870,1047,1917
198561001,110 MAIN ST,BOILING SPRINGS,NC,28017,1156,2442,3598
198570001,201 HWY 321 SOUTH,DALLAS,NC,28034,1867,3495,5362
157438002,790 Thomas More Parkway,Edgewood,KY,41017,1964,2129,4093
105145001,108 N. 40TH Street,Phoenix,AZ,85034,2162,2919,5081
130396001,20 CHURCH STREET,NEW HAVEN,CT,6510,2861,4155,7016
238759001,3520 30TH AVE,KENOSHA,WI,531441690,2765,4272,7037
114938001,5055 SANTA TERESA BLVD,GILROY,CA,95020,2654,2995,5649
191339001,One College Road,BATAVIA,NY,14020,2049,3481,5530
212656001,3200 COLLEGE AVE,BEAVER FALLS,PA,150103599,791,752,1543
101286001,1141 Wallace Drive,DOTHAN,AL,363039234,1566,3044,4610
101295001,801 MAIN ST NW,HANCEVILLE,AL,350772000,1780,3277,5057
101301001,3000 EARL GOODWIN PARKWAY,SELMA,AL,367032808,567,908,1475
208822001,414 N MERIDIAN ST,NEWBERG,OR,97132,1581,2360,3941
232186001,4400 UNIVERSITY DR,FAIRFAX,VA,220304444,17663,19653,37316
131469001,2121 I ST NW,WASHINGTON,DC,20052,11232,16940,28172
156745001,400 EAST COLLEGE ST,GEORGETOWN,KY,40324,565,1043,1608
131496001,37TH AND O ST NW,WASHINGTON,DC,20057,8757,10447,19204
139861001,231 W HANCOCK ST,MILLEDGEVILLE,GA,31061,2531,4458,6989
447689001,1000 University Center Lane,Lawrenceville,GA,30043,5378,7130,12508
139700001,3175  Cedartown Hwy.,ROME,GA,30161,2375,3809,6184
139755001,225 NORTH AVE NW,ATLANTA,GA,30332,22736,9987,32723
485111001,201 E Greene St,Milledgeville,GA,31061,3253,5559,8812
139384001,ONE MAURICE CULBERSON DR,ROME,GA,30161,2178,3659,5837
244446001,495 N INDIAN CREEK DR,CLARKSTON,GA,300212397,1237,2137,3374
139931001,P. O. Box 8033,Statesboro,GA,30460,11511,14897,26408
139764001,800 Georgia Southwestern State University Dr.,Americus,GA,317094693,951,1956,2907
139940001,PO Box 3965,ATLANTA,GA,303023965,13891,20425,34316
184773001,900 LAKEWOOD AVENUE,LAKEWOOD,NJ,87012697,676,1782,2458
232195001,2130 GERMANNA HWY,LOCUST GROVE,VA,225082102,2836,4371,7207
212674001,300 N WASHINGTON ST,GETTYSBURG,PA,173251486,1162,1279,2441
169974001,62249 SHIMMEL RD,CENTREVILLE,MI,490329719,527,674,1201
104708001,6000 W OLIVE AVE,GLENDALE,AZ,85302,8254,9688,17942
237385001,200 HIGH ST,GLENVILLE,WV,263511292,896,690,1586
115083001,536 Mission St.,San Francisco,CA,941052968,1271,1244,2515
115126001,15744 GOLDEN WEST,HUNTINGTON BEACH,CA,926472710,5255,6366,11621
130989001,4701 LIMESTONE RD,WILMINGTON,DE,198081927,653,840,1493
235316001,E 502 BOONE AVE,SPOKANE,WA,992580001,3294,4269,7563
129154001,One Riverside Drive,East Hartford,CT,6118,677,2720,3397
165936001,255 Grapevine Road,Wenham,MA,1984,674,1281,1955
139968001,419 COLLEGE DR,BARNESVILLE,GA,302041762,1179,2484,3663
165945001,130 ESSEX ST,SOUTH HAMILTON,MA,1982,1149,547,1696
162654001,1021 DULANEY VALLEY RD,BALTIMORE,MD,212042794,658,1609,2267
145336001,1 UNIVERSITY PKY,UNIVERSITY PARK,IL,60484,1671,3186,4857
170000001,1011 ALDON SW,WYOMING,MI,49509,439,577,1016
150677001,200 Seminary Drive,Winona Lake,IN,46590,828,1201,2029
153366001,1 University Place,Lamoni,IA,50140,600,1393,1993
159009001,100 FOUNDER STREET,GRAMBLING,LA,71245,1929,3276,5205
104717001,3300 W CAMELBACK RD,PHOENIX,AZ,85017,24543,65710,90253
170055001,143 BOSTWICK AVE NE,GRAND RAPIDS,MI,495033295,6551,7237,13788
170082001,1 Campus Dr.,Allendale,MI,494014903,9682,14995,24677
153375001,1200 GRANDVIEW AVE,DES MOINES,IA,50316,828,1058,1886
183257001,25 Hall Street,CONCORD,NH,3301,601,1424,2025
235334001,1620 EDWARD P SMITH DR,ABERDEEN,WA,985207599,855,1013,1868
225070001,6101 GRAYSON DRIVE,DENISON,TX,750208299,1726,2646,4372
182306001,1500 College Parkway,Elko,NV,89801,1177,2274,3451
183150001,320 Corporate Drive,Portsmouth,NH,3801,819,1068,1887
180249001,2100 16TH AVE S,GREAT FALLS,MT,59405,451,1063,1514
235343001,12401 SE 320TH ST,AUBURN,WA,980923699,4301,4170,8471
165981001,ONE COLLEGE DR,GREENFIELD,MA,13019739,692,1130,1822
198598001,815 W MARKET ST,GREENSBORO,NC,274011875,479,547,1026
218113001,738 S. Pleasantburg Dr.,Greenville,SC,296072418,4378,6486,10864
145372001,315 E. COLLEGE AVE.,GREENVILLE,IL,622460159,567,565,1132
153384001,1115 8th Avenue,GRINNELL,IA,501121690,788,928,1716
115296001,8800 GROSSMONT COLLEGE DR,EL CAJON,CA,92020,7448,10387,17835
240745001,P.O. Box 23069,GMF Barrigada,GU,96921,932,1150,2082
198613001,5800 W FRIENDLY AVE,GREENSBORO,NC,27410,769,807,1576
198622001,601 E. Main St.,JAMESTOWN,NC,27282,4414,6106,10520
134343001,5230 W HWY 98,PANAMA CITY,FL,32401,2170,3474,5644
459213001,2121 S El Camino Real Bldg C 200,San Mateo,CA,94403,335,1352,1687
173647001,800 West College Avenue,Saint Peter,MN,560821498,931,1310,2241
140012001,5150 SUGARLOAF PKY,LAWRENCEVILLE,GA,300431505,3711,5413,9124
212832001,1325 Sumneytown Pike,Gwynedd Valley,PA,194370901,817,2239,3056
102313001,P.O. Box 10048,MONTGOMERY,AL,361083199,823,1032,1855
162690001,11400 ROBINWOOD DR,HAGERSTOWN,MD,217426514,1500,2656,4156
191515001,198 COLLEGE HILL RD,CLINTON,NY,13323,950,1055,2005
173665001,1536 HEWITT AVENUE,SAINT PAUL,MN,551041284,1211,2315,3526
232256001,"College Road, Box 128",Hampden-Sydney,VA,239430128,1070,2,1072
166018001,893 WEST ST,AMHERST,MA,10023359,457,734,1191
232265001,200 William R Harvey Way,HAMPTON,VA,236680099,1445,2876,4321
150756001,517 Ball Drive,Hanover,IN,47243,498,606,1104
212869001,750 Montgomery Avemie,Bryn Mawr,PA,19010,255,1088,1343
225247001,2200 Hickory,Abilene,TX,79698,1098,1246,2344
107044001,900 E. Center,Searcy,AR,72149,2247,2874,5121
162706001,401 THOMAS RUN ROAD,BEL AIR,MD,210151698,2509,3356,5865
177551001,3026 LACLEDE AVE,SAINT LOUIS,MO,631032136,573,1143,1716
212878001,ONE HACC Drive,HARRISBURG,PA,17110,6439,11642,18081
446640001,326 Market Street,Harrisburg,PA,171012208,2642,2161,4803
115393001,411 Central Avenue,SALINAS,CA,93901,6625,5896,12521
191533001,One Hartwick Drive,ONEONTA,NY,138204020,486,690,1176
166027001,Massachusetts Hall,Cambridge,MA,2138,15841,15725,31566
181127001,710 Turner Ave,Hastings,NE,68901,543,537,1080
212911001,370 W. LANCASTER AVE,HAVERFORD,PA,190411392,636,674,1310
383190001,1175 Manono Street,Hilo,HI,967205096,1003,1629,2632
141644001,1164 Bishop Street,Honolulu,HI,96813,1670,2416,4086
153445001,1501 E ORANGE RD,WATERLOO,IA,507048015,2338,2925,5263
198668001,185 FREEDLANDER DR,CLYDE,NC,28721,637,990,1627
156790001,One Community College Dr.,HAZARD,KY,417012402,1545,1640,3185
384342001,1500 West Raab Road,Normal,IL,61761,2270,2793,5063
203085001,310 E MARKET ST,TIFFIN,OH,448832462,590,629,1219
180276001,1115 N ROBERTS ST,HELENA,MT,59601,679,841,1520
156851001,2660 S GREEN ST,HENDERSON,KY,424204699,506,1080,1586
107071001,1100 HENDERSON ST,ARKADELPHIA,AR,719990001,1610,2351,3961
107080001,1600 WASHINGTON AVE,CONWAY,AR,720323080,579,629,1208
173708001,9000 Brooklyn Blvd,Brooklyn Park,MN,55445,3074,1688,4762
170240001,5101 Evergreen Road,Dearborn,MI,481281495,5569,6650,12219
191612001,100 RESERVOIR RD,HERKIMER,NY,133501598,984,1414,2398
240392001,5218 E. TERRACE DR.,MADISON,WI,53718,393,1747,2140
173735001,1515 E 25TH ST,HIBBING,MN,55746,483,635,1118
198695001,1 University Parkway,HIGH POINT,NC,272683598,2120,3017,5137
145521001,2998 W PEARL CITY RD,FREEPORT,IL,610329341,613,983,1596
235431001,2400 S 240th St,Des Moines,WA,981989800,2701,3829,6530
225371001,112 LAMAR,HILLSBORO,TX,76645,1751,2696,4447
134495001,4001 Tampa Bay Blvd.,TAMPA,FL,33614,9954,13229,23183
175786001,608 Hinds Blvd,Raymond,MS,39154,4867,7654,12521
203128001,11753 Garfield Road,HIRAM,OH,44234,538,717,1255
191630001,300 Pulteney Street,GENEVA,NY,14456,1084,1157,2241
203155001,3301 Hocking Parkway,Nelsonville,OH,457649588,1675,1787,3462
367884001,2647 Professional circle,Naples,FL,341197932,401,650,1051
191649001,1000 Hempstead Turnpike,HEMPSTEAD,NY,115491170,4591,6280,10871
175810001,9216 HW 14,GOODMAN,MS,39079,1958,3720,5678
212984001,9801 Frankford Ave,PHILADELPHIA,PA,191142094,756,2333,3089
166133001,303 HOMESTEAD AVE,HOLYOKE,MA,1040,1925,3281,5206
203386001,4140 Executive Parkway,Westerville,OH,430813855,155,1954,2109
141680001,874 DILLINGHAM BLVD,HONOLULU,HI,96817,2103,1438,3541
162760001,401 ROSEMONT AVE,FREDERICK,MD,21701,713,1292,2005
170301001,141 E 12TH St,Holland,MI,49422,1204,1945,3149
120537001,2500 E Nutwood Ave,Fullerton,CA,928313104,510,743,1253
156860001,720 North Drive,Hopkinsville,KY,422412100,1077,1671,2748
218140001,2050 HWY. 501 E.,CONWAY,SC,29526,2470,4318,6788
191676001,1 WILLARD AVE,HOUGHTON,NY,14744,402,599,1001
129543001,900 LAFAYETTE BLVD,BRIDGEPORT,CT,66044704,1869,3143,5012
225399001,7502 Fondren Rd.,Houston,TX,770743298,1109,2323,3432
225423001,1300 Holman,Houston,TX,77004,23356,33844,57200
225520001,1001 BIRDWELL LN,BIG SPRING,TX,79720,1737,2748,4485
162779001,10901 Little Patuxent Parkway,Columbia,MD,210443197,3941,5270,9211
225548001,1000 Fisk Street,Brownwood,TX,768012715,560,467,1027
131520001,2400 Sixth St. NW,Washington,DC,200590001,2995,6144,9139
184995001,7o Sip Avenue,JERSEY CITY,NJ,73064012,3418,4990,8408
191719001,80 VANDENBURGH AVE,TROY,NY,12180,5530,5366,10896
164368001,1 Education St,Cambridge,MA,21411805,1753,1312,3065
115755001,1 HARPST STREET,ARCATA,CA,955218299,3383,4589,7972
191728001,3601 HEMPSTEAD TPK,LEVITTOWN,NY,117561375,186,907,1093
101435001,1500 East Fairview Avenue,Montgomery,AL,361062148,545,536,1081
150941001,2303 COLLEGE AVE,HUNTINGTON,IN,46750,501,801,1302
487524001,1 College Circle,Bangor,ME,4401,1505,2256,3761
225575001,900 CHICON ST,AUSTIN,TX,787022795,425,694,1119
155195001,1300 N. Plum St.,Hutchinson,KS,67501,2534,3040,5574
193405001,1 GUSTAVE L LEVY PLACE,NEW YORK,NY,100296574,539,675,1214
142276001,"921 S. 8th Ave., Stop 8310",Pocatello,ID,832098140,5386,6977,12363
145682001,ONE COLLEGE DR,EAST PEORIA,IL,616350001,3763,5112,8875
145725001,10 West 35th Street,CHICAGO,IL,60616,4294,2459,6753
145813001,201 S. School St. Hovey Hall rm 421 Campus Box 1000,NORMAL,IL,617901000,8942,11693,20635
145831001,815 N Orlando Smith Road,Oglesby,IL,613489692,1236,1722,2958
145646001,1312 N PARK ST,BLOOMINGTON,IL,617022900,808,885,1693
213011001,1145 KING RD,IMMACULATA,PA,19345,613,1835,2448
115861001,380 E. Aten Road,IMPERIAL,CA,922510158,3660,4680,8340
465812001,4021 S 700 E Ste 400,Salt Lake City,UT,84107,2144,7951,10095
418296001,2403 N 41ST ST E,MUSKOGEE,OK,74403,806,431,1237
153472001,525 GRANDVIEW,OTTUMWA,IA,52501,1954,1964,3918
134608001,3209 VIRGINIA AVE,FORT PIERCE,FL,349815596,6531,10155,16686
151290001,1600 E WASHINGTON BLVD,Fort Wayne,IN,468031297,1355,863,2218
492962001,1600 E. Washington Blvd.,Fort Wayne,IN,468031297,1549,3165,4714
151324001,200 N 7TH ST,TERRE HAUTE,IN,47809,5614,7430,13044
213020001,850 MAPLE STREET,INDIANA,PA,15705,4777,6706,11483
151351001,"Bryan Hall 100, 107 South Indiana",BLOOMINGTON,IN,474057000,22197,21306,43503
151388001,2325 CHESTER BLVD,RICHMOND,IN,47374,1301,2421,3722
151333001,2450 S WASHINGTON,KOKOMO,IN,469049003,1114,2009,3123
151360001,3400 BROADWAY,GARY,IN,46408,1189,2770,3959
151102001,2101 E COLISEUM BLVD,FORT WAYNE,IN,468051499,4670,5469,10139
151111001,301 University Blvd.,INDIANAPOLIS,IN,462022896,12482,17097,29579
151342001,1700 Mishawaka Avenue,SOUTH BEND,IN,466151408,1877,3337,5214
151379001,4201 GRANT LINE RD,NEW ALBANY,IN,471506405,2018,3126,5144
151801001,4201 South Washington Street,MARION,IN,469534974,1074,2114,3188
488679001,1900 West 50th Street,Marion,IN,46953,3030,7584,10614
431141001,564 W. Herndon,CLOVIS,CA,93612,415,718,1133
242422002,"Calle Ferrocarril 709, Esquina Concordia",Ponce,PR,7175033,3538,4757,8295
242626001,P.O. BOX 20000,AGUADILLA,PR,605,1636,2267,3903
242635001,"BO SAN DANIEL SECTOR LAS CANELAS, Carr. 2 Km. 80.4",ARECIBO,PR,614,1498,2456,3954
242644001,BO HELECHAL CARR 156 INTERSECCION 719,BARRANQUITAS,PR,7940517,605,1035,1640
242705001,500 ROAD 830,BAYAMON,PR,957,2363,1930,4293
242680001,CALLE UNION BATEY CENTRAL CARR 195,FAJARDO,PR,7387003,748,1141,1889
242699001,BO MACHETE ST. 744 KM 1.2,GUAYAMA,PR,785,593,1133,1726
242653001,CARRETERA #1 KM 16. 3 ESQ CALLE FRANCISCO SEIN,SAN JUAN,PR,9191293,3124,4707,7831
242662001,104 TURPEAUX IND PARK,MERCEDITA,PR,7151602,1764,2840,4604
242617001,INTERAMERICAN UNIVERSITY AVENUE,SAN GERMAN,PR,6839801,2049,2401,4450
173799001,2500 80TH ST E,INVER GROVE HEIGHTS,MN,550763224,1718,2546,4264
191931001,715 NORTH AVE,NEW ROCHELLE,NY,108011890,1854,2072,3926
153524001,One Triton Circle,FORT DODGE,IA,50501,2667,2723,5390
153533001,300 S 18th Street,Estherville,IA,51334,900,1151,2051
153603001,"515 Morrill Road, Room 1750 Beardshear Hall",Ames,IA,500112103,19910,15082,34992
153630001,2700 COLLEGE RD BOX 4C,COUNCIL BLUFFS,IA,515023004,2651,3311,5962
116439001,5500 Irvine Center Drive,Irvine,CA,926180301,6466,6586,13052
198710001,286 ICC Loop Road,SPINDALE,NC,281600804,786,1155,1941
173805001,1851 HWY 169 E,GRAND RAPIDS,MN,557443397,576,619,1195
175829001,602 W HILL ST,FULTON,MS,388431099,2000,2930,4930
191968001,953 Danby Rd,Ithaca,NY,148507002,2732,3785,6517
150987001,50 WEST FALL CREEK PARKWAY NORTH DRIVE,INDIANAPOLIS,IN,462085752,30574,41432,72006
232414001,1651 E. Parham Road,RICHMOND,VA,23285,3519,5218,8737
170444001,2111 EMMONS RD,JACKSON,MI,492018399,2333,2750,5083
220400001,2046 NORTH PKY,JACKSON,TN,383013797,1694,3168,4862
175856001,1400 J R Lynch St.,Jackson,MS,39217,2387,4863,7250
101480001,700 Pelham Road North,Jacksonville,AL,36265,3470,5009,8479
134945001,2800 UNIVERSITY BLVD N,JACKSONVILLE,FL,322113394,1501,2712,4213
203678001,4240 CAMPUS DR,LIMA,OH,458044242,1455,2547,4002
232423001,800 South Main Street,HARRISONBURG,VA,22807,8895,12856,21751
198729001,133 JAMES SPRUNT DRIVE,KENANSVILLE,NC,283490398,363,750,1113
191986001,525 FALCONER ST,JAMESTOWN,NY,14702,1853,2623,4476
177676001,1000 VIKING DR,HILLSBORO,MO,630502440,1656,2776,4432
231837001,101 Elm Avenue SE,ROANOKE,VA,24013,220,908,1128
156921001,109 E BROADWAY,LOUISVILLE,KY,402022005,5011,6688,11699
192022001,1220 COFFEEN ST,WATERTOWN,NY,13601,1314,1963,3277
101505001,2601 CARSON RD,BIRMINGHAM,AL,352153098,3518,5560,9078
455196001,546 U.S. Highway 46,Teterboro,NJ,7608,293,2886,3179
146205001,700 LOGAN COLLEGE ROAD,CARTERVILLE,IL,62918,1573,2467,4040
107141001,2000 W UNIVERSITY ST,SILOAM SPRINGS,AR,727612121,1021,1495,2516
101514001,HWY 31 N,DECATUR,AL,356092216,4498,5238,9736
203368001,1 John Carroll Boulevard,University Heights,OH,441184581,1802,1753,3555
232450001,13101 JEFFERSON DAVIS HWY,CHESTER,VA,238315399,4396,5748,10144
146278001,1301 S. 48th St.,Quincy,IL,623058736,771,1153,1924
162928001,3400 N CHARLES ST,BALTIMORE,MD,212182688,12149,14003,26152
445708001,801 West Trade Street,Charlotte,NC,28202,552,1129,1681
439288001,7150 MONTVIEW BLVD.,DENVER,CO,80220,393,615,1008
414823001,1701 NE 127TH ST,NORTH MIAMI,FL,33181,492,869,1361
217235001,8 Abbott Park Place,Providence,RI,29033703,2927,4433,7360
198756001,100-152 BEATTIES FORD RD,CHARLOTTE,NC,282165302,585,980,1565
155210001,12345 COLLEGE BLVD,OVERLAND PARK,KS,662101299,8403,9970,18373
230913001,337 College Hill,JOHNSON,VT,56569464,1070,1520,2590
220473001,7900 JOHNSON DR,KNOXVILLE,TN,37998,598,490,1088
198774001,245 COLLEGE ROAD,SMITHFIELD,NC,275772350,1478,2569,4047
146296001,1215 HOUBOLT RD,JOLIET,IL,60431,6573,8153,14726
175883001,900 SOUTH COURT ST,ELLISVILLE,MS,39437,1794,2702,4496
146339001,1151 N STATE ST,ELGIN,IL,601231498,486,770,1256
213251001,1700 MOORE ST,HUNTINGDON,PA,166522196,625,808,1433
170532001,1200 ACADEMY ST,KALAMAZOO,MI,490063295,625,842,1467
170541001,P.O. Box 4070,KALAMAZOO,MI,490034070,3789,4280,8069
146348001,100 College Drive,Kankakee,IL,609016505,1081,1741,2822
155292001,7250 STATE AVE,KANSAS CITY,KS,66112,2345,3540,5885
179812001,1750 INDEPENDENCE Ave,KANSAS CITY,MO,641061453,732,478,1210
155399001,110 ANDERSON HALL,MANHATTAN,KS,665061303,11244,10977,22221
141796001,4303 Diamond Head Road,Honolulu,HI,96816,2756,4143,6899
260901001,"2660 East 53rd Street, Suite 6/7",Davenport,IA,52807,9354,21158,30512
489779002,"9000 Keystone Crossing, Suite 800",Indianapolis,IN,46240,378,1120,1498
146366001,27210 COLLEGE RD,CENTRALIA,IL,62801,1225,1939,3164
141802001,3-1901 KAUMUALII HWY,LIHUE,HI,96766,501,985,1486
185262001,1000 MORRIS AVE,UNION,NJ,70830411,5240,8816,14056
183062001,229 Main Street,Keene,NH,3435,1588,1955,3543
135081001,1500 NW 49 Street,FORT LAUDERDALE,FL,333090000,6013,13497,19510
170550001,450 NORTH AVE,BATTLE CREEK,MI,490173397,1391,2854,4245
161192001,92 WESTERN AVE,FAIRFIELD,ME,49371367,869,1604,2473
486840002,1000 Chastain Road,KENNESAW,GA,301445591,18154,17266,35420
203447001,3300 Lake Rd. West,ASHTABULA,OH,44004,738,1288,2026
203456001,400 E 4TH ST,EAST LIVERPOOL,OH,43920,361,762,1123
203526001,14111 CLARIDON-TROY RD,BURTON,OH,44021,804,1375,2179
203517001,500 East Main Street,Kent,OH,442420001,10579,17543,28122
203492001,2491 ST RT 45 S,SALEM,OH,44460,491,1206,1697
203465001,6000 FRANK AVE NW,NORTH CANTON,OH,44720,1847,2924,4771
203474001,4314 MAHONING AVE NW,WARREN,OH,444831998,859,1385,2244
203483001,330 UNIVERSITY DR NE,NEW PHILADELPHIA,OH,44663,918,1250,2168
157058001,400 E MAIN ST,FRANKFORT,KY,40601,728,1050,1778
203535001,101 Scott Lane,GAMBIER,OH,43022,777,953,1730
169983001,1700 University Avenue,Flint,MI,485046214,1830,485,2315
192192001,141 Central Avenue,Keuka Park,NY,14478,472,1454,1926
213303001,ONE COLLEGE GREEN,LA PLUME,PA,184400200,519,905,1424
226019001,1100 Broadway,Kilgore,TX,756623299,2025,2841,4866
220516001,1350 King College Road,Bristol,TN,37620,709,1239,1948
213321001,133 N RIVER ST,WILKES-BARRE,PA,18711,1249,1320,2569
153737001,6301 Kirkwood Blvd SW,Cedar Rapids,IA,52404,6478,7428,13906
170587001,10775 N ST HELEN RD,ROSCOMMON,MI,48653,590,899,1489
146418001,21193 MALTA RD,MALTA,IL,601509699,1500,1807,3307
428392001,7390 South Sixth Street,KLAMATH FALLS,OR,976037121,620,894,1514
146427001,2 E SOUTH ST,GALESBURG,IL,614019999,579,754,1333
213349001,15200 KUTZTOWN RD    P.O. BOX   730,KUTZTOWN,PA,195300730,3669,4621,8290
213358001,9000 BABCOCK BLVD,PITTSBURGH,PA,15237,620,823,1443
213367001,1900 W OLNEY AVE,PHILADELPHIA,PA,191411199,1857,3334,5191
117627001,4500 Riverwalk Parkway,RIVERSIDE,CA,925158247,908,1431,2339
155450001,200 S 14TH,PARSONS,KS,676574201,717,1461,2178
213376001,501 VINE ST,SCRANTON,PA,185093206,878,995,1873
213385001,HIGH ST,EASTON,PA,180421768,1262,1380,2642
140234001,601 Broad Street,LaGrange,GA,302402999,469,560,1029
219143001,"1201 Arrow Ave, PO Box 730",WATERTOWN,SD,572010730,1187,1058,2245
203580001,391 W WASHINGTON ST,PAINESVILLE,OH,440773389,515,645,1160
407629001,1858 W GRANDVIEW BLVD,ERIE,PA,165091025,2151,2078,4229
146481001,555 N SHERIDAN ROAD,LAKE FOREST,IL,600452399,644,868,1512
146506001,5001 LAKE LAND BLVD,MATTOON,IL,61938,1939,2644,4583
170620001,2755 E NAPIER AVE,BENTON HARBOR,MI,490221899,1307,1895,3202
200192001,1801 COLLEGE DR N,DEVILS LAKE,ND,583011598,893,1179,2072
173461001,2101 TRINITY RD,DULUTH,MN,558113399,2406,2875,5281
170639001,650 W Easterday Ave,Sault Sainte Marie,MI,49783,950,1041,1991
117195001,One College Drive,South Lake Tahoe,CA,96150,1258,1146,2404
235699001,11605 132ND AVE NE,KIRKLAND,WA,980348506,1474,2196,3670
135188001,9501 US HWY 441,LEESBURG,FL,347888751,1827,2985,4812
203599001,7700 CLOCKTOWER DR,KIRTLAND,OH,440945198,2742,4123,6865
238980001,W3718 South Drive,Plymouth,WI,53073,971,1526,2497
239008001,1290 NORTH AVE,CLEVELAND,WI,530151414,1368,1595,2963
441760001,855 E LAVACA,BEAUMONT,TX,77705,1613,1652,3265
226107001,410 FRONT ST,ORANGE,TX,776305899,755,1595,2350
226116001,1500 PROCTER ST,PORT ARTHUR,TX,77640,1006,1435,2441
226091001,4400 MLK,BEAUMONT,TX,77710,5316,9467,14783
213400001,901 EDEN RD,LANCASTER,PA,17601,1078,1044,2122
218229001,320 Stanley Avenue,Greenwood,SC,296492099,959,2085,3044
220598001,545 LANE AVE,JACKSON,TN,383014598,640,592,1232
209038001,4000 E 30TH AVE,EUGENE,OR,97405,4276,4753,9029
117247001,900 FALLON ST,OAKLAND,CA,94607,4758,5646,10404
207209001,102 Page Hall,LANGSTON,OK,730500907,775,1344,2119
140243001,2535 Lanier Tech Drive,Gainesville,GA,30507,1729,2322,4051
170657001,411 N. Grand Ave.,Lansing,MI,48933,5502,6269,11771
240620001,1400 E. College Drive,Cheyenne,WY,820073299,1628,2469,4097
226134001,West  End Washington St.,Laredo,TX,780404395,4451,5730,10181
366401001,3000 Campus Hill Drive,LIVERMORE,CA,94551,4330,4648,8978
166391001,1844 COMMONWEALTH AVE,Auburndale,MA,24662716,750,1310,2060
117274001,478-200 HWY 139,SUSANVILLE,CA,96130,2140,520,2660
170675001,21000 W TEN MILE RD,SOUTHFIELD,MI,480751058,2135,780,2915
239017001,711 E. Boldt Way,APPLETON,WI,54911,680,783,1463
101569001,3060 WILSON RD SW,BIRMINGHAM,AL,352211717,1279,1995,3274
230418001,95 North 300 West,SALT LAKE CITY,UT,841013500,1059,937,1996
192323001,1419 Salt Springs Road,Syracuse,NY,13214,1255,2101,3356
213507001,101 N COLLEGE AVE,ANNVILLE,PA,170031400,874,1048,1922
226204001,200 Lee Drive,BAYTOWN,TX,77520,4161,3612,7773
220613001,1120 N OCOEE ST,CLEVELAND,TN,373203731,2119,3267,5386
141811001,96-045 Ala Ike,Pearl City,HI,967823393,2598,4111,6709
213525001,4525 EDUCATION PARK DR,SCHNECKSVILLE,PA,180782598,2728,4381,7109
213543001,27 MEMORIAL DR W,BETHLEHEM,PA,18015,3725,3124,6849
198817001,231 HIGHWAY 58 SOUTH,KINSTON,NC,285020188,1044,1649,2693
198835001,625 7TH Ave. NE,HICKORY,NC,28601,962,1738,2700
166452001,29 Everett Street,CAMBRIDGE,MA,21382790,838,4000,4838
226231001,2100 S. Mobberly Ave.,Longview,TX,75602,1545,1630,3175
209056001,0615 SW PALATINE HILL RD,PORTLAND,OR,972197899,1208,2188,3396
146603001,5800 GODFREY RD,GODFREY,IL,62035,2978,3720,6698
146612001,ONE UNIVERSITY PARKWAY,ROMEOVILLE,IL,604462200,2799,3641,6440
142328001,500 8th Avenue,Lewiston,ID,835012698,1348,2336,3684
232557001,1971 UNIVERSITY BLVD,LYNCHBURG,VA,24502,32437,46715,79152
140252001,1269 Barclay Circle,Marietta,GA,30060,1351,1395,2746
192271001,12 E 53RD ST,New York,NY,100225268,188,1593,1781
218238001,1115 College Drive,Gaffney,SC,293403799,1076,1366,2442
126951001,11194 E. 45th Ave,DENVER,CO,80239,1225,78,1303
226277001,2915 Alouette Drive,GRAND PRAIRIE,TX,75052,1056,40,1096
221148001,1524 GALLATIN RD,NASHVILLE,TN,37206,1622,70,1692
146685001,5250 SHEPHERD RD,SPRINGFIELD,IL,627949256,2248,3317,5565
220631001,6965 CUMBERLAND GAP PKY,HARROGATE,TN,377529900,1687,3111,4798
185396001,2299 VAUXHALL RD,UNION,NJ,7083,1325,43,1368
177968001,209 South Kingshighway,Saint Charles,MO,633011695,3887,5581,9468
157216001,210 LINDSEY WILSON ST,COLUMBIA,KY,427281223,903,1686,2589
209065001,900 SE BAKER,MCMINNVILLE,OR,971286894,543,833,1376
209074001,6500 Pacific Blvd SW,Albany,OR,97321,2554,3005,5559
219976001,3901 GRANNY WHITE PIKE,NASHVILLE,TN,372043951,1739,2881,4620
192448001,720 NORTHERN BLVD,BROOKVILLE,NY,115481300,4959,10237,15196
198862001,701 West Monroe Street,Salisbury,NC,28144,571,577,1148
213613001,401 N. Fairview Street,Lock Haven,PA,177452390,1385,2033,3418
177986001,1851 SCHOETTLER RD,CHESTERFIELD,MO,63017,719,863,1582
117636001,11206 Campus Street Suite A,LOMA LINDA,CA,92354,1581,2867,4448
227182001,5000 Research Forest Drive,The Woodlands,TX,773814356,29569,43930,73499
117645001,4901 East Carson Street,Long Beach,CA,90808,10591,13254,23845
232566001,201 HIGH ST Lancaster Hall,FARMVILLE,VA,23909,1475,3436,4911
203748001,1005 N ABBE RD,ELYRIA,OH,440351691,4108,6536,10644
153825001,1450 ALTA VISTA,DUBUQUE,IA,520010178,805,684,1489
232575001,173 SKIRMISHER LANE,MIDDLETOWN,VA,226451745,2646,4152,6798
117788001,855 North Vermont Ave.,Los Angeles,CA,900293516,5910,7999,13909
436429001,6363 Sunset Blvd,Hollywood,CA,90028,2770,1036,3806
117690001,1111 Figueroa Place,Wilmington,CA,907442397,3606,5098,8704
117867001,13356 Eldridge Avenue,Sylmar,CA,913423245,3954,5928,9882
117706001,6201 Winnetka Avenue,Woodland Hills,CA,913710002,7970,9694,17664
117715001,1600 W. Imperial Hwy.,Los Angeles,CA,900474810,1776,3902,5678
117724001,400 W. Washington Blvd.,Los Angeles,CA,900154181,6985,6372,13357
117733001,5800 Fulton Avenue,Valley Glen,CA,914014096,7016,9178,16194
117894001,2700 East LELAND Road,PITTSBURG,CA,94565,4298,5449,9747
159568001,1140 COLLEGE DR,PINEVILLE,LA,713590381,586,659,1245
483212001,7500 Millhaven Road,Monroe,LA,71203,1506,2309,3815
159391001,"University Administration BLDG, 3810 W. Lakeshore Drive",BATON ROUGE,LA,70808,14426,16557,30983
159373001,433 BOLIVAR ST,NEW ORLEANS,LA,701122223,881,1928,2809
159382001,8100 HWY 71 SOUTH,ALEXANDRIA,LA,713029121,979,2185,3164
159407001,2048 JOHNSON HWY,EUNICE,LA,70535,933,2299,3232
159416001,ONE UNIVERSITY PLACE,SHREVEPORT,LA,711152399,2933,4103,7036
159647001,305 Wisteria,RUSTON,LA,71272,6084,5825,11909
203757001,6832 CONVENT BLVD,Sylvania,OH,435602898,510,934,1444
235750001,1600 Maple,LONGVIEW,WA,986320310,882,1937,2819
117946001,One LMU Drive,LOS ANGELES,CA,900452659,4180,5658,9838
146719001,1032 W. Sheridan Rd.,CHICAGO,IL,60626,5711,11296,17007
163046001,4501 North Charles Street,Baltimore,MD,212102699,2106,3539,5645
159656001,6363 ST CHARLES AVE,NEW ORLEANS,LA,701186143,1447,2814,4261
226383001,5601 19TH ST,LUBBOCK,TX,794072099,639,1166,1805
363633001,366 Luna Dr.,LAS VEGAS,NM,87701,483,610,1093
101602001,1000 Dannelly Blvd.,ANDALUSIA,AL,364201418,773,1011,1784
153834001,700 COLLEGE DR,DECORAH,IA,521011045,857,1148,2005
213659001,1333 S PROSPECT ST,NANTICOKE,PA,186343899,1925,3059,4984
213668001,ONE COLLEGE PL,WILLIAMSPORT,PA,177015192,541,601,1142
132657001,3601 N. MILITARY TRAIL,BOCA RATON,FL,334315598,1519,1574,3093
173902001,1600 GRAND AVE,SAINT PAUL,MN,551051801,879,1295,2174
170790001,14500 E TWELVE MILE RD,WARREN,MI,480883896,9386,10834,20220
238263001,1701 Wright Street,MADISON,WI,53704,6734,8516,15250
157304001,2000 College Drive,Madisonville,KY,424319199,1637,1909,3546
170806001,36600 SCHOOLCRAFT RD,LIVONIA,MI,481501176,993,2051,3044
153861001,1000 N 4TH ST,FAIRFIELD,IA,52557,1078,511,1589
203775001,2600 Cleveland Avenue NW,CANTON,OH,447093308,649,1018,1667
135407001,6305 St. Rd. 70 East,BRADENTON,FL,34203,662,470,1132
129695001,Great Path       P.O. Box 1046,Manchester,CT,60451046,2709,3294,6003
151777001,604 E. COLLEGE AVE,NORTH MANCHESTER,IN,46962,696,829,1525
192703001,4513 Manhattan College Parkway,Bronx,NY,104714098,2306,1926,4232
192712001,130 CLAREMONT AVE,NEW YORK,NY,100274698,459,549,1008
192749001,2900 PURCHASE ST,PURCHASE,NY,10577,905,1589,2494
213783001,"5 Swan Street, 501 North Hall",MANSFIELD,PA,169331621,633,996,1629
239071001,745 W MAIN ST,WATERTOWN,WI,53094,495,540,1035
151786001,3200 COLD SPRING RD,INDIANAPOLIS,IN,462221997,1387,2205,3592
203845001,IRVINE BLDG,MARIETTA,OH,457504031,632,498,1130
203881001,1467 Mt. Vernon Avenue,Marion,OH,433025694,963,1432,2395
192819001,3399 NORTH RD,POUGHKEEPSIE,NY,12601,2781,3843,6624
239105001,1250 W. Wisconsin Ave,Milwaukee,WI,532011881,5271,6334,11605
198899001,100 ATHLETIC ST,MARS HILL,NC,28754,531,623,1154
237525001,1 John Marshall Drive,HUNTINGTON,WV,25755,5348,7856,13204
153922001,3700 S CENTER ST,MARSHALLTOWN,IA,50158,858,1073,1931
232672001,NEW & FREDERICK ST,STAUNTON,VA,24401,283,1619,1902
163295001,1300 MT ROYAL AVE,BALTIMORE,MD,212174191,563,1615,2178
164085001,7750 Montpelier Road,Laurel,MD,20723,101,964,1065
192864001,221 E 71 Street,NEW YORK,NY,100214597,447,1616,2063
232706001,2807 N GLEBE RD,ARLINGTON,VA,222074299,1131,2287,3418
220710001,502 E LAMAR ALEXANDER PKWY,MARYVILLE,TN,378045907,510,636,1146
178059001,650 Maryville University Drive,Saint Louis,MO,631417299,2445,6694,9139
213826001,2300 ADAMS AVE,SCRANTON,PA,185091598,819,2034,2853
166647001,50 OAKLAND ST,WELLESLEY HILLS,MA,24815399,2056,2312,4368
166674001,621 HUNTINGTON AVE,BOSTON,MA,21155801,597,1490,2087
167288001,375 Church Street,North Adams,MA,12474100,537,915,1452
166683001,77 MASSACHUSETTS AVE,CAMBRIDGE,MA,21394307,6972,4602,11574
166692001,101 ACADEMY DR,BUZZARDS BAY,MA,25321803,1535,267,1802
166823001,ONE MASSASOIT BLVD,BROCKTON,MA,23023996,2974,4021,6995
198914001,200 Mayland Drive,Spruce Pine,NC,28777,469,613,1082
173957001,200 1ST ST SW,ROCHESTER,MN,55905,472,651,1123
157331001,1755 US Highway 68,MAYSVILLE,KY,41056,1829,2360,4189
200226001,330 3RD ST NE,MAYVILLE,ND,582571229,449,735,1184
164270001,2 COLLEGE HILL,WESTMINSTER,MD,211574390,1001,1779,2780
198923001,54 College Drive,MARION,NC,287528728,417,688,1105
147004001,8900 US HWY 14,CRYSTAL LAKE,IL,600122761,3365,3666,7031
147013001,701 COLLEGE RD,LEBANON,IL,622541299,1080,1414,2494
226578001,1400 COLLEGE DR,WACO,TX,76708,2976,5979,8955
226587001,1 McMurry University,Abilene,TX,79697,569,563,1132
159717001,4205 RYAN ST,LAKE CHARLES,LA,70609,3024,4623,7647
166656001,179 LONGWOOD AVE,BOSTON,MA,21155896,2046,5018,7064
414461001,P.O. BOX 6118,CAGUAS,PR,7250000,2292,124,2416
192925001,18 AGASSIZ CIR,BUFFALO,NY,142142695,539,1607,2146
239169001,8701 WATERTOWN PLANK RD,MILWAUKEE,WI,532260509,716,697,1413
218335001,Colcock Hall - 179 ASHLEY AVE MSC 001,CHARLESTON,SC,29425,1101,1843,2944
118684001,1000 HENSLEY CREEK ROAD,UKIAH,CA,95482,1500,2398,3898
118718001,3600 M ST,MERCED,CA,953482898,4487,6508,10995
185509001,1200 OLD TRENTON RD,West Windsor,NJ,85503407,3641,4045,7686
140447001,1501 Mercer University Drive,Macon,GA,31207,3173,5567,8740
193016001,555 Broadway,Dobbs Ferry,NY,10522,2775,6256,9031
203960001,2221 MADISON AVE,TOLEDO,OH,436041132,216,1295,1511
213987001,501 East 38th Street,Erie,PA,165460001,1108,1577,2685
198950001,3800 HILLSBOROUGH ST,RALEIGH,NC,276075298,43,1862,1905
175935001,910 HWY 19 N,MERIDIAN,MS,39307,1049,2445,3494
166850001,315 TURNPIKE ST,NORTH ANDOVER,MA,1845,2140,2503,4643
118772001,12500 CAMPUS DR,OAKLAND,CA,946193196,2608,4845,7453
105154001,1833 W SOUTHERN AVE,MESA,AZ,85202,9539,10848,20387
173993001,1001 CHESTNUT ST WEST,VIRGINIA,MN,55792,617,571,1188
188261001,911 S TENTH ST,TUCUMCARI,NM,884013352,682,386,1068
213996001,ONE COLLEGE AVE,Mechanicsburg,PA,17055,1216,2159,3375
198969001,5400 RAMSEY ST,FAYETTEVILLE,NC,283111420,1029,1063,2092
363165001,1900 Springlake Drive,Oklahoma City,OK,731115240,620,605,1225
190114001,60 West Street,New York,NY,100061742,292,735,1027
181303001,5730 N 30TH ST,OMAHA,NE,681111689,6864,8049,14913
177995001,500 SW Longview Rd.,Lee's Summit,MO,640812105,6772,9579,16351
174020001,700 E SEVENTH ST,SAINT PAUL,MN,551065000,3204,4657,7861
127565001,P.O. Box 173362,DENVER,CO,802173362,9257,10935,20192
166869001,"Charlestown Navy Yard, 36 1ST Avenue",BOSTON,MA,21294557,232,1018,1250
135717001,300 NE 2ND Avenue,MIAMI,FL,331322204,23410,31563,54973
204006001,1601 University Blvd.,Hamilton,OH,45011,1260,1391,2651
204015001,4200 N University Blvd,Middletown,OH,450423497,845,986,1831
204024001,501 East High Street,Oxford,OH,45056,9472,10462,19934
171100001,"Hannah Administration Bldg., 426 Auditorium Road, Room 450",EAST LANSING,MI,488241042,24237,26114,50351
171128001,1400 Townsend Drive,Houghton,MI,499311295,5156,2016,7172
171155001,1375 S CLARE AVE,HARRISON,MI,486259447,1582,2220,3802
245953001,3500 SW 119TH ST,OKLAHOMA CITY,OK,731709797,690,1248,1938
181312001,601 West State Farm Road,North Platte,NE,69101,909,1307,2216
239220001,500 32nd Street North,Wisconsin Rapids,WI,54494,1149,1541,2690
155520001,2030 E. COLLEGE WAY,OLATHE,KS,660621899,647,1228,1875
482158001,100 University Parkway,MACON,GA,312065144,3321,4481,7802
220978001,1301 East Main Street,MURFREESBORO,TN,37132,9771,11860,21631
230959001,OLD CHAPEL ROAD,MIDDLEBURY,VT,5753,1212,1399,2611
129756001,100 TRAINING HILL RD,MIDDLETOWN,CT,6457,1064,1483,2547
185536001,2600 Woodbridge Avenue,EDISON,NJ,8837,5195,5699,10894
226806001,3600 N GARFIELD,MIDLAND,TX,797056397,2187,3265,5452
181330001,900 N. CLARKSON,FREMONT,NE,68025,911,962,1873
218353001,1260 Lexington Drive,West Columbia,SC,29170,3927,5965,9892
157377001,512 STEPHENS ST,MIDWAY,KY,403471120,499,1169,1668
178208001,5001 N. Oak Trafficway,Kansas City,MO,641184697,2351,446,2797
226833001,3410 TAFT BLVD,WICHITA FALLS,TX,763082099,2351,3751,6102
143853001,555 31ST STREET,DOWNERS GROVE,IL,605155514,1207,1777,2984
423643001,19555 N. 59th Avenue,Glendale,AZ,85308,1763,2060,3823
101675001,5500 Myron Massey Blvd,Fairfield,AL,35064,736,814,1550
198978001,5000 Market Street,WILMINGTON,NC,28405,311,1556,1867
460835001,2451 Highway 501 East,Conway,SC,29528,194,1148,1342
214041001,po box 1002,MILLERSVILLE,PA,175510302,3156,4590,7746
486901001,1 Blowers Blvd.,Johnson City,TN,37682,522,703,1225
147244001,1184 W MAIN ST,DECATUR,IL,625222084,887,1207,2094
118888001,5000 MACARTHUR BLVD,OAKLAND,CA,94613,114,1143,1257
239248001,700 W STATE STREET,MILWAUKEE,WI,532331443,6438,8840,15278
239318001,1025 N BROADWAY,MILWAUKEE,WI,532023109,2067,753,2820
178217001,"P. O. Box 1000, 5270 FLAT RIVER ROAD",PARK HILLS,MO,636011000,1089,1796,2885
174136001,1501 HENNEPIN AVE,MINNEAPOLIS,MN,554031779,3041,3910,6951
175263001,1250 HOMER RD,WINONA,MN,55987,842,1008,1850
173559001,1414 COLLEGE WAY,FERGUS FALLS,MN,565371000,2570,3652,6222
174358001,1104 7th Avenue South,Moorhead,MN,56563,2201,3659,5860
173920001,309 Wigley Administration Center,MANKATO,MN,56001,6426,7948,14374
173638001,1593 11th Avenue,Granite Falls,MN,56241,1631,1731,3362
200253001,500 UNIVERSITY AVE W,MINOT,ND,58707,1249,1940,3189
118912001,ONE BARNARD DR,OCEANSIDE,CA,920563899,5790,7930,13720
214069001,301 LAKE ST,DALLAS,PA,186121098,772,1794,2566
118930001,3000 Mission College Blvd,Santa Clara,CA,95054,3568,4212,7780
176053001,200 S CAPITOL ST,CLINTON,MS,390584059,1870,3233,5103
176008001,HWY 3 AND CHERRY ST,MOORHEAD,MS,387610668,883,1490,2373
176071001,51 MAIN STREET,PERKINSTON,MS,39573,3553,5397,8950
176080001,Butler Williams Buiding,MISSISSIPPI STATE,MS,39762,10999,10975,21974
176035001,1100 College Street,COLUMBUS,MS,39701,544,2167,2711
176044001,14000 HIGHWAY 82 WEST,ITTA BENA,MS,389411400,887,1398,2285
178244001,ONE COLLEGE PARK DR,SAINT LOUIS,MO,631418660,1935,3357,5292
178341001,3950 E NEWMAN RD,JOPLIN,MO,648011595,2279,3727,6006
179566001,901 S NATIONAL,SPRINGFIELD,MO,65897,9733,13964,23697
179344001,128 GARFIELD AVENUE,WEST PLAINS,MO,657752715,666,1203,1869
178411001,"300 W. 13th Street, 206 Parker Hall",ROLLA,MO,654091060,6567,2034,8601
178369001,500 E COLLEGE ST,MARSHALL,MO,65340,992,875,1867
178387001,4525 DOWNS DR,SAINT JOSEPH,MO,64507,2237,3432,5669
198987001,500 W BROAD STREET,STATESVILLE,NC,286775293,1258,1906,3164
175281001,875 SUMMIT AVE,SAINT PAUL,MN,551053076,560,594,1154
219189001,1800 East Spruce Street,MITCHELL,SD,573012002,811,387,1198
178448001,101 COLLEGE AVE,MOBERLY,MO,652701304,2100,3102,5202
118976001,435 COLLEGE AVE,MODESTO,CA,953505800,7142,10766,17908
105206001,1971 Jagerson Ave,Kingman,AZ,864091238,1372,2699,4071
193283001,1101 SHERMAN DR,UTICA,NY,13501,2941,3376,6317
193292001,1000 HEMPSTEAD AVE,ROCKVILLE CENTRE,NY,115715002,1217,3712,4929
185572001,400 CEDAR AVE,WEST LONG BRANCH,NJ,77641898,2322,3845,6167
193308001,MONROE COLLEGE WAY,BRONX,NY,10468,2435,3951,6386
193326001,1000 E HENRIETTA RD,ROCHESTER,NY,146235780,5747,6526,12273
171225001,1555 SOUTH  RAISINVILLE ROAD,MONROE,MI,481619904,1201,1719,2920
180461001,Montana State University-Bozeman,Bozeman,MT,59717,8927,7887,16814
180179001,1500 University Drive,BILLINGS,MT,591010298,1493,2822,4315
180522001,300 W 11TH ST,HAVRE,MT,59501,581,509,1090
180416001,1300 W PARK ST,BUTTE,MT,597018997,1196,648,1844
171234001,2800 COLLEGE DR,SIDNEY,MI,488859723,647,1020,1667
185590001,VALLEY RD AND NORMAL AVE,MONTCLAIR,NJ,70431624,7752,13363,21115
119067001,980 FREMONT ST,MONTEREY,CA,939404799,3711,4306,8017
163426001,51 Mannakee St,ROCKVILLE,MD,20850,10064,11656,21720
214111001,340 DEKALB PIKE,BLUE BELL,PA,194220796,4482,5969,10451
147369001,820 N LaSalle Blvd,Chicago,IL,606103284,1754,1332,3086
248606001,4701 12TH AVE NW,NORMAN,OK,730698399,988,698,1686
119137001,7075 Campus Rd,Moorpark,CA,93021,6790,7567,14357
239372001,235 N NATIONAL AVE,FOND DU LAC,WI,549361940,1801,2669,4470
147378001,9000 W. College Parkway,PALOS HILLS,IL,604650937,6690,7072,13762
214157001,1200 MAIN ST,BETHLEHEM,PA,180186650,924,1590,2514
157386001,150 University Blvd,Morehead,KY,40351,3996,6199,10195
140553001,830 WESTVIEW DR SW,ATLANTA,GA,30314,2205,1,2206
460394001,16130 Lasselle St,Moreno Valley,CA,925512045,4162,5912,10074
127617001,920 Barlow Road,Fort Morgan,CO,807014371,467,761,1228
163453001,1700 E COLD SPRING LN,BALTIMORE,MD,212510001,3405,4307,7712
154004001,1501 MORNINGSIDE AVE,SIOUX CITY,IA,511061751,860,1838,2698
196051001,State Route 20,MORRISVILLE,NY,134080901,1535,1451,2986
147411001,3801 S CENTRAL AVE,CICERO,IL,608044398,1807,2544,4351
221096001,P.O. Box 8500,Lynchburg,TN,373528500,2686,4200,6886
169275001,1401 E Court St,Flint,MI,48503,3053,4662,7715
214166001,7373 ADMIRAL PEARY HWY,CRESSON,PA,16630,574,1210,1784
204176001,127 S.  DAVIS AVE,COLUMBUS,OH,432221504,123,967,1090
166939001,50 College Street,SOUTH HADLEY,MA,1075,24,2311,2335
219198001,1105 W. 8TH STREET,YANKTON,SD,570783724,439,605,1044
239390001,2900 N. MENOMONEE RIVER PKY,MILWAUKEE,WI,532224597,49,1290,1339
154013001,1330 ELMHURST DR NE,CEDAR RAPIDS,IA,524024797,590,1245,1835
204200001,5701 DELHI RD,CINCINNATI,OH,452331670,756,1406,2162
193353001,330 POWELL AVE,NEWBURGH,NY,12550,644,1708,2352
119173001,12001 CHALON RD,LOS ANGELES,CA,900491599,262,2703,2965
163462001,16300 OLD EMMITSBURG RD,EMMITSBURG,MD,21727,1232,1174,2406
204194001,800 MARTINSBURG RD,MOUNT VERNON,OH,430509500,817,1426,2243
166957001,444 GREEN ST,GARDNER,MA,14401000,1365,2359,3724
232788001,3441 Mountain Empire Road,BIG STONE GAP,VA,242190700,1000,1506,2506
226930001,4849 W ILLINOIS,DALLAS,TX,752116599,4782,6837,11619
448248001,2301 West Ashton Blvd,Lehi,UT,84043,1329,1472,2801
444954001,One Mountwest Way,HUNTINGTON,WV,25701,878,995,1873
209250001,26000 SE STARK ST,GRESHAM,OR,97030,4698,3914,8612
119164001,1100 N GRAND AVE,WALNUT,CA,917891399,13930,15416,29346
119216001,1499 N STATE ST,SAN JACINTO,CA,925832399,6382,9369,15751
214175001,2400 Chew Street,Allentown,PA,18104,923,1417,2340
207236001,ONE MURRAY CAMPUS,TISHOMINGO,OK,73460,690,1453,2143
157401001,218 WELLS HALL,MURRAY,KY,42071,3714,5740,9454
119270001,1655 McCadden PLace,Los Angeles,CA,90028,805,300,1105
171304001,221 S QUARTERLINE RD,MUSKEGON,MI,49442,1656,2422,4078
204264001,163 STORMONT STREET,NEW CONCORD,OH,43762,859,1553,2412
451477001,380 Polaris Parkway,Westerville,OH,43082,1028,195,1223
480037001,5511 Capital Center Dr Ste 500,Raleigh,NC,27606,1484,325,1809
119331001,2277 NAPA VALLEJO HWY,NAPA,CA,945586236,2396,3107,5503
442611001,220 BYERS CREEK RD,MOORESVILLE,NC,28117,1082,39,1121
199087001,522 N. Old Carriage Road,Rocky Mount,NC,27804,1239,1816,3055
183141001,505 AMHERST ST,NASHUA,NH,30631026,793,833,1626
221184001,120 WHITE BRIDGE RD,NASHVILLE,TN,372094515,3359,4925,8284
193478001,1 Education Drive,East Garden City,NY,11530,8501,8905,17406
219204001,5301 S Highway 16,RAPID CITY,SD,577013692,600,1065,1665
119553001,5900 Doyle ST,EMERYVILLE,CA,946082008,365,750,1115
147536001,122 S MICHIGAN AVE,CHICAGO,IL,60603,1384,4608,5992
106980001,101 COLLEGE DR,HOT SPRINGS,AR,71913,814,1203,2017
119605001,11355 N TORREY PINES RD,LA JOLLA,CA,92037,6286,10644,16930
242972001,ST RD 2 NATIONAL COLLEGE PLAZA BLDG. KM.,BAYAMON,PR,9602036,3338,7922,11260
129729001,750 CHASE PARKWAY,WATERBURY,CT,67083089,2633,3604,6237
187596001,"Box 849, Lower Point Road, State Road 371",CROWNPOINT,NM,873130849,665,935,1600
227146001,3200 W 7TH AVENUE,CORSICANA,TX,75110,3448,5153,8601
193584001,4245 EAST AVE,ROCHESTER,NY,146183790,725,2262,2987
181297001,720 North 87th Street,Omaha,NE,68114,112,990,1102
181446001,5000 Saint Paul Avenue,LINCOLN,NE,685042794,815,1280,2095
155566001,800 W 14TH ST,CHANUTE,KS,66720,774,1194,1968
214272001,ONE NEUMANN DRIVE,ASTON,PA,190141298,866,1732,2598
441900001,1300 Nevada State Drive,Henderson,NV,89002,1181,3749,4930
182980001,98 BRIDGE ST,HENNIKER,NH,3242,1186,1335,2521
217305001,1 New England Tech Blvd,East Greenwich,RI,2818,1790,973,2763
185129001,2039 KENNEDY BLVD,JERSEY CITY,NJ,7305,3039,4952,7991
185828001,UNIVERSITY HTS,NEWARK,NJ,71021982,8430,2993,11423
187897001,UNIVERSITY AVE,LAS VEGAS,NM,87701,1033,2004,3037
187967001,801 Leroy Place,Socorro,NM,878014796,1249,646,1895
187903001,5317 LOVINGTON HWY,HOBBS,NM,88240,758,1489,2247
187994001,2400 NORTH SCENIC DRIVE,ALAMOGORDO,NM,88310,608,1028,1636
188003001,1500 UNIVERSITY DR,CARLSBAD,NM,88220,676,1115,1791
187620001,3400 S Espina,Las Cruces,NM,880038001,3292,4584,7876
188030001,2850 Weddell Street,LAS CRUCES,NM,880038001,6347,7942,14289
447582001,280 University Drive,Beaver,WV,25813,379,790,1169
232867001,5251 College Drive,DUBLIN,VA,240841127,2259,2160,4419
461148001,3300 W. Riverside Drive,Burbank,CA,915051002,763,626,1389
194091001,Northern Blvd,Old Westbury,NY,115688000,4003,3170,7173
193821001,185 West Broadway,NEW YORK,NY,100132960,439,603,1042
193830001,40 Sunshine Cottage Rd.,Valhalla,NY,10595,575,887,1462
193900001,70 WASHINGTON SQ SOUTH,NEW YORK,NY,10012,22033,29814,51847
218414001,2100 COLLEGE ST,NEWBERRY,SC,29108,693,515,1208
155335001,3100 MCCORMICK AVE,WICHITA,KS,672132097,1198,2175,3373
183099001,31 College Dr,CONCORD,NH,33017412,1495,1983,3478
193946001,3111 SAUNDERS SETTLEMENT RD,SANBORN,NY,14132,2163,2884,5047
193973001,5795 Lewiston Road,NIAGARA UNIVERSITY,NY,14109,1355,2408,3763
159966001,UNIVERSITY STATION  LA HWY 1,THIBODAUX,LA,70310,2238,4215,6453
167260001,CENTER RD,DUDLEY,MA,15715000,943,649,1592
239442001,"5364 College Drive, P.O. Box 518",RHINELANDER,WI,545010518,511,772,1283
460464001,2001 Third St,Norco,CA,928602600,5129,5746,10875
232937001,700 Park Avenue,Norfolk,VA,235048000,1797,3407,5204
174428001,9700 FRANCE AVE S,BLOOMINGTON,MN,554314399,4269,5515,9784
107460001,1515 PIONEER DR.,HARRISON,AR,72601,723,1089,1812
199102001,1601 E. Market Street,Greensboro,NC,27411,5223,6919,12142
199157001,1801 FAYETTEVILLE ST,DURHAM,NC,27707,2533,5674,8207
199193001,2101 Hillsborough Street,RALEIGH,NC,276957001,18917,16562,35479
199209001,3400 N WESLEYAN BLVD,ROCKY MOUNT,NC,27804,892,1142,2034
147660001,30 N BRAINARD ST,NAPERVILLE,IL,60540,1328,1600,2928
171395001,1515 Howard Street,Petoskey,MI,49770,885,1444,2329
179715001,1301 Main Street,Trenton,MO,64683,573,1281,1854
204422001,2441 KENWOOD CIR,MANSFIELD,OH,44906,1195,1768,2963
224110001,1525 West California,Gainesville,TX,762404699,4452,6073,10525
174437001,910 ELLIOT AVE S,MINNEAPOLIS,MN,554041391,501,614,1115
194028001,23 Santanoni Avenue Box 89,SARANAC LAKE,NY,129830089,770,1208,1978
200305001,800 N 6TH ST,WAHPETON,ND,58076,1632,1325,2957
200332001,1301  12th Avenue North,FARGO,ND,58102,7357,6439,13796
136145001,325 NW TURNER DAVIS DR,MADISON,FL,32340,408,821,1229
140678001,1500 GEORGIA HWY 197 NORTH,CLARKESVILLE,GA,30523,1005,1607,2612
218441001,7801 N. Tigerville Road,TIGERVILLE,SC,296881892,1216,1362,2578
174376001,7411 85TH AVE N,BROOKLYN PARK,MN,55445,2570,3716,6286
142443001,1000 W GARDEN AVENUE,COEUR D'ALENE,ID,838142199,2032,3238,5270
154059001,500 COLLEGE DR,MASON CITY,IA,50401,1293,1702,2995
227191001,5001 N MACARTHUR BLVD,IRVING,TX,750383899,5195,6317,11512
147679001,3225 W . Foster Avenue,Chicago,IL,606254895,1082,1818,2900
236072001,9600 COLLEGE WAY NORTH,SEATTLE,WA,981033599,2342,3587,5929
167312001,1 Ferncroft Rd,Danvers,MA,19230840,2147,3616,5763
214379001,3835 GREEN POND RD,BETHLEHEM,PA,180207599,3798,5971,9769
239460001,1000 CAMPUS DR,WAUSAU,WI,544011899,2715,3680,6395
101897001,P.O. Box 159  / 138 Alabama Hwy 35,Rainsville,AL,35986,1089,1794,2883
181491001,801 E BENJAMIN AVENUE,NORFOLK,NE,687020469,2661,2355,5016
154110001,1625 HWY 150,CALMAR,IA,521329989,1806,2643,4449
488730001,1201 Kitty Hawk Rd,Universal City,TX,78145,2385,3125,5510
176169001,101 CUNNINGHAM BLVD,BOONEVILLE,MS,388291726,1363,2149,3512
221908001,2425 HWY 75,BLOUNTVILLE,TN,376170246,2897,3242,6139
227225001,FM 1735,MOUNT PLEASANT,TX,75455,1219,1872,3091
239488001,2740 W MASON ST,GREEN BAY,WI,543079042,4942,6563,11505
147776001,5500 N ST LOUIS AVE,CHICAGO,IL,606254699,3410,4693,8103
127732001,100 COLLEGE AVE,STERLING,CO,80751,649,843,1492
207290001,200 I ST NE,Miami,OK,74354,848,1049,1897
207263001,600 N GRAND,TAHLEQUAH,OK,744642399,2886,4993,7879
217837001,1201 CHESTERFIELD HWY.,CHERAW,SC,295201007,467,808,1275
167358001,360 HUNTINGTON AVE,BOSTON,MA,2115,11263,10364,21627
105330001,"1900 S. Knoles Drive, Babbitt Administrative Center",FLAGSTAFF,AZ,86011,11812,19254,31066
167376001,100 Elliott Street,Haverhill,MA,18302399,2066,3167,5233
147703001,1425 West Lincoln Highway,DeKalb,IL,601152854,8345,8824,17169
157447001,"Nunn Drive, AC 800B",Highland Heights,KY,41099,5899,8865,14764
240790001,Fina Sisu Lane,Saipan,MP,969501250,453,741,1194
171456001,1401 PRESQUE ISLE,MARQUETTE,MI,49855,3286,4309,7595
207281001,1220 E GRAND AVE,TONKAWA,OK,74653,1637,2544,4181
219259001,1200 S JAY ST,ABERDEEN,SD,574017198,1366,2127,3493
232946001,4001 WAKEFIELD CHAPEL RD,ANNANDALE,VA,220033796,24620,26309,50929
174473001,1101 HWY 1E,THIEF RIVER FALLS,MN,56701,1448,2052,3500
105349001,2251 N. Navajo Boulevard PO Box 610,Holbrook,AZ,860250610,1262,1920,3182
160667001,1710 Sullivan Dr.,Bogalusa,LA,70427,2046,2687,4733
367459001,ONE COLLEGE DR,BENTONVILLE,AR,727125091,3446,4533,7979
445948001,"7398 Smoke Ranch Road, Ste 100",Las Vegas,NV,89128,163,904,1067
240657001,231 W 6TH ST,POWELL,WY,82435,610,878,1488
136233001,100 COLLEGE BLVD E,NICEVILLE,FL,325781295,2218,3279,5497
154129001,603 W PARK ST,SHELDON,IA,51201,739,1008,1747
160010001,9500 Industrial Drive,MINDEN,LA,710580835,555,475,1030
176178001,4975 HWY 51 N,SENATOBIA,MS,38668,2939,4679,7618
178624001,800 UNIVERSITY DRIVE,MARYVILLE,MO,644686001,2903,3954,6857
142461001,623 S. University Boulevard,Nampa,ID,836865897,851,1350,2201
204440001,22600 State Route 34,ARCHBOLD,OH,435029542,1244,1133,2377
173115001,905 GRANT AVE SE,BEMIDJI,MN,566014907,316,706,1022
236133001,5520 108th Ave NE,Kirkland,WA,980830579,453,868,1321
487603001,5520 108th Ave NE,Kirkland,WA,98033,534,621,1155
420398001,3535 NORTH ELLISON DR,SAN ANTONIO,TX,78251,7050,9243,16293
101736001,800 GEORGE WALLACE BLVD,MUSCLE SHOALS,AL,35661,1392,2147,3539
154101001,101 SEVENTH ST SW,ORANGE CITY,IA,51041,491,808,1299
130040001,PARK PL E,WINSTED,CT,6098,442,857,1299
171483001,1701 E FRONT ST,TRAVERSE CITY,MI,49686,1815,1912,3727
207306001,709 OKLAHOMA BLVD,ALVA,OK,737172799,779,1213,1992
160038001,UNIVERSITY PARKWAY,NATCHITOCHES,LA,71497,3180,7901,11081
147767001,633 CLARK ST,EVANSTON,IL,602081320,11108,11019,22127
171492001,4000 Whiting Dr,MIDLAND,MI,48640,1799,1378,3177
130004001,188 Richards Avenue,Norwalk,CT,68541655,2346,3067,5413
230995001,158 Harmon Drive,NORTHFIELD,VT,56631035,2959,1027,3986
204468001,4545 COLLEGE RD,Cleveland,OH,441214293,775,925,1700
120184001,1500 RALSTON AVE,BELMONT,CA,940021997,441,1051,1492
163578001,4701 North Charles Street,Baltimore,MD,212102476,307,2064,2371
136215001,3301 College Ave.,Ft. Lauderdale-Davie,FL,333147796,5956,14479,20435
158884001,3710 Paris Road,Chalmette,LA,70043,873,1498,2371
194161001,1 South Boulevard,Nyack,NY,10960,1016,1335,2351
152099001,138 N LUCRETIA ST,OAKLAND CITY,IN,476601099,670,749,1419
171535001,2900 Featherstone Road,Auburn Hills,MI,483262845,7137,8274,15411
171571001,2200 North Squirrel Rd.,ROCHESTER,MI,483094401,8440,10869,19309
147800001,1600 E GOLF RD,DES PLAINES,IL,600161268,4104,4350,8454
101912001,7000 ADVENTIST BLVD NW,HUNTSVILLE,AL,358960003,690,946,1636
204501001,70 N PROFESSOR ST,OBERLIN,OH,44074,1205,1607,2812
120254001,1600 CAMPUS RD,LOS ANGELES,CA,900413392,815,1115,1930
185873001,1 College Drive,Toms River,NJ,87542001,3524,4652,8176
420431001,1189 DEEPSTEP RD,SANDERSVILLE,GA,31082,541,887,1428
227304001,201 W UNIVERSITY,ODESSA,TX,797647127,2704,4379,7083
230490001,200 N Washington Blvd,OGDEN,UT,844044089,1316,961,2277
366465001,One Joseph E. Kennedy Blvd.,Statesboro,GA,30458,616,1398,2014
219277001,490 Piya Wiconi Road,KYLE,SD,577520490,427,873,1300
140696001,4484 PEACHTREE RD NE,ATLANTA,GA,303192797,541,723,1264
201964001,1476 LANCASTER PIKE,CIRCLEVILLE,OH,43113,1340,2320,3660
204617001,1216 SUNBURY RD,COLUMBUS,OH,43219,723,993,1716
204635001,525  SOUTH MAIN ST,ADA,OH,458101599,1547,1492,3039
204671001,4240 CAMPUS DRIVE,LIMA,OH,45804,464,546,1010
204796001,190 N. OVAL MALL,COLUMBUS,OH,43210,30395,30775,61170
204680001,1760 University Drive,MANSFIELD,OH,44906,522,577,1099
204699001,1461 MT VERNON AVE,MARION,OH,433025695,642,610,1252
204705001,1179 UNIVERSITY DR,NEWARK,OH,43055,1428,1454,2882
204820001,101 University Dr.,CHILLICOTHE,OH,45601,536,1050,1586
204848001,1570 GRANVILLE PIKE,LANCASTER,OH,43130,637,931,1568
204857001,Cutler Hall 108,ATHENS,OH,457012979,11862,16618,28480
204839001,1804 LIBERTY AVE,IRONTON,OH,45638,386,849,1235
204866001,1425 NEWARK RD,ZANESVILLE,OH,43701,330,773,1103
204909001,61 S SANDUSKY STREET,DELAWARE,OH,430152370,713,848,1561
120290001,43600 Mission Blvd.,Fremont,CA,945390390,4193,4642,8835
207403001,500 W UNIVERSITY,SHAWNEE,OK,74804,806,1205,2011
207324001,2501 E MEMORIAL ROAD,Edmond,OK,730135599,1165,1063,2228
207449001,7777 S MAY AVE,OKLAHOMA CITY,OK,731599987,4648,7391,12039
207458001,2501 N BLACKWELDER,OKLAHOMA CITY,OK,731061402,989,1784,2773
207351001,323 EAGLE AVE,Goodwell,OK,739390430,614,648,1262
207564001,1801 E 4TH ST,OKMULGEE,OK,744473901,1536,865,2401
207388001,"Whitehurst Hall, Rm. 107",Stillwater,OK,740781015,12451,12239,24690
207397001,900 N PORTLAND,OKLAHOMA CITY,OK,731076195,2106,3595,5701
206835001,2201 SILVER LAKE RD,BARTLESVILLE,OK,740066299,444,652,1096
232982001,5115 HAMPTON BLVD,NORFOLK,VA,23529,10567,13609,24176
171599001,320 South Main Street,OLIVET,MI,49076,607,491,1098
147828001,One University Avenue,Bourbonnais,IL,609142271,1612,3043,4655
145707001,305 NORTH WEST ST,OLNEY,IL,62450,426,686,1112
236188001,1600 CHESTER AVE,Bremerton,WA,983371699,3075,3545,6620
194222001,4585 West Seneca Turnpike,Syracuse,NY,132154585,4732,5102,9834
207582001,7777 S LEWIS,TULSA,OK,74171,1668,2385,4053
120342001,2701 FAIRVIEW ROAD,COSTA MESA,CA,92626,10831,10291,21122
194240001,115 SOUTH ST,MIDDLETOWN,NY,10940,2732,3885,6617
135735001,2900 West Oak Ridge Road,Orlando,FL,32809,1798,590,2388
136303001,301 W AMELIA ST.,ORLANDO,FL,32801,386,682,1068
138372001,955 E STORY RD,WINTER GARDEN,FL,34787,992,602,1594
138488001,901 W. WEBSTER AVE.,WINTER PARK,FL,32789,589,492,1081
218487001,3250 ST MATTHEWS RD,ORANGEBURG,SC,291188299,794,1593,2387
209490001,3181 SW SAM JACKSON PK RD,Portland,OR,97239,1015,1984,2999
209506001,3201 Campus Drive,Klamath Falls,OR,976018801,2737,2598,5335
209542001,"600 Kerr Administration, OSU",Corvallis,OR,97331,16354,14632,30986
440828001,1500 SW Chandler Avenue,BEND,OR,97702,554,705,1259
127778001,1802 COLORADO AVE,LA JUNTA,CO,81050,556,706,1262
120403001,9045 Lincoln Boulevard,Los Angeles,CA,900453505,387,757,1144
204936001,1 S. Grove Street,WESTERVILLE,OH,43081,1065,1821,2886
107512001,410 OUACHITA ST,ARKADELPHIA,AR,719980001,745,915,1660
227331001,411 SW 24TH ST,SAN ANTONIO,TX,782074689,778,2371,3149
204945001,30335 OREGON RD,Perrysburg,OH,435510000,4850,4610,9460
247940001,4800 NEW HARTFORD RD,OWENSBORO,KY,42303,1843,2097,3940
120421001,4000 S Rose Avenue,Oxnard,CA,93030,3372,4046,7418
107549001,218 COLLEGE DR,MELBOURNE,AR,725560010,319,804,1123
177472001,1001 East Chestnut Expressway,SPRINGFIELD,MO,658023625,4956,7265,12221
194310001,1 PACE PLAZA,NEW YORK,NY,100381598,5098,8228,13326
236230001,12180 Park Ave S,Tacoma,WA,98447,1118,2089,3207
120768002,45 Eureka Street,Pasadena,CA,91103,116,995,1111
120865001,One Angwin Avenue,Angwin,CA,945089707,412,650,1062
209612001,2043 COLLEGE WAY,FOREST GROVE,OR,97116,1286,2652,3938
136330001,901 S. Flagler Drive  PO BOX 24708,WEST PALM BEACH,FL,334164708,1313,2392,3705
136358001,4200 CONGRESS AVE,LAKE WORTH,FL,334614796,13266,18550,31816
154174001,1000 BRADY ST,DAVENPORT,IA,528035287,1266,913,2179
246354001,1400 VILLARET,SAN ANTONIO,TX,782242499,3874,5978,9852
120698001,1791 Arastradero Rd.,Palo Alto,CA,94304,230,841,1071
120953001,ONE COLLEGE DRIVE,BLYTHE,CA,92225,3483,635,4118
120971001,1140 West Mission Road,San Marcos,CA,920691487,12603,11314,23917
227386001,1109 W PANOLA ST,CARTHAGE,TX,75633,875,1891,2766
364016001,18401 N 32ND ST,PHOENIX,AZ,85032,3585,4530,8115
227401001,2400 CLARKSVILLE ST,PARIS,TX,754606298,1988,2971,4959
178721001,8700 NW River Park Drive,Parkville,MO,641523795,6083,5332,11415
243823001,2500 WALNUT HILL LN,DALLAS,TX,752295668,685,750,1435
147916001,2400 W BRADLEY AVE,CHAMPAIGN,IL,618211899,3251,3823,7074
121044001,1570 E COLORADO BLVD,PASADENA,CA,911062003,12792,14070,26862
136400001,10230 Ridge Road,New Port Richey,FL,346545199,4405,7120,11525
186034001,ONE COLLEGE BLVD,PATERSON,NJ,75051179,2540,3940,6480
233019001,645 Patriot Avenue,Martinsville,VA,24112,916,1350,2266
233037001,100 N COLLEGE DR,FRANKLIN,VA,238510737,479,809,1288
176239001,101 HWY 11 N,POPLARVILLE,MS,39470,1858,2978,4836
214883001,1420 PINE STREET,PHILADELPHIA,PA,191024699,376,981,1357
221643001,10915 Hardin Valley Road,KNOXVILLE,TN,379330990,5119,5775,10894
236258001,1502 E LAURIDSEN BLVD,PORT ANGELES,WA,983626698,930,1122,2052
442356001,850 Greenfield Road,Lancaster,PA,17601,244,1556,1800
366252001,ONE COLLEGE AVE,WILLIAMSPORT,PA,177015799,3333,1989,5322
414911001,101 Community College Way,JOHNSTOWN,PA,159040068,1059,1599,2658
214777001,201 OLD MAIN,UNIVERSITY PARK,PA,168021589,24985,21825,46810
214801001,1600 WOODLAND RD,ABINGTON,PA,190013918,1909,1837,3746
214689001,3000 IVYSIDE PK,ALTOONA,PA,16601,1779,1465,3244
214704001,TULPEHOCKEN RD,READING,PA,196106009,1554,1024,2578
214731001,25 YEARSLEY MILL RD,MEDIA,PA,19063,813,538,1351
214591001,4701 College Drive,ERIE,PA,16563,2844,1468,4312
214713001,777 W HARRISBURG PKE,MIDDLETOWN,PA,170574898,2899,2034,4933
136473001,1000 College Boulevard,Pensacola,FL,32504,3685,6088,9773
121150001,24255 Pacific Coast Highway,Malibu,CA,90263,3032,4929,7961
181534001,600 Hoyt Street,Peru,NE,684210010,808,1306,2114
199306001,48380 HWY 52N,MISENHEIMER,NC,281090960,512,853,1365
215123001,4170 CITY AVE,PHILADELPHIA,PA,19131,1139,1716,2855
107600001,900 DAISY BATES DRIVE,LITTLE ROCK,AR,722023799,337,663,1000
107619001,1000 CAMPUS DR,HELENA,AR,723420785,598,922,1520
105428001,1202 W Thomas Rd,Phoenix,AZ,85013,3878,7081,10959
128151001,500 AIRPORT BLVD,AURORA,CO,800119307,646,566,1212
140818001,1021 CENTRAL AVE,DEMOREST,GA,305350010,629,1820,2449
199324001,1715 COLLEGE DR,ROXBORO,NC,27573,495,792,1287
218520001,620 NORTH EMERALD ROAD,GREENWOOD,SC,29646,1611,2880,4491
233116001,501 COLLEGE DR,CHARLOTTESVILLE,VA,229027589,2348,3097,5445
235237001,9401 Farwest Drive SW,Lakewood,WA,984981999,2230,3837,6067
439145001,1601 39TH Avenue SE,PUYALLUP,WA,983742222,1795,2658,4453
443492001,1201 LOCUST AVE,FAIRMONT,WV,26554,713,1115,1828
127820001,5675 S ACADEMY BLVD,COLORADO SPRINGS,CO,809065422,5547,7657,13204
105525001,2202 W. Anklam Rd.,Tucson,AZ,857090001,8589,11005,19594
105534001,3350 E GRANT RD Suite 100,TUCSON,AZ,85716,375,1476,1851
174570001,900 4TH ST SE,PINE CITY,MN,55063,902,1118,2020
199333001,1986 Pitt Tech Road,WINTERVILLE,NC,28590,3188,4997,8185
155681001,1701 S BROADWAY,PITTSBURG,KS,66762,3208,3417,6625
215415001,1111 McKee Road,Oakdale,PA,15071,940,711,1651
121257001,1050 N MILLS AVE,CLAREMONT,CA,917116110,472,600,1072
183080001,17 HIGH ST,PLYMOUTH,NH,32641595,2390,2669,5059
121309001,3900 LOMALAND DR,SAN DIEGO,CA,921062899,1520,3072,4592
215442001,201 WOOD ST,PITTSBURGH,PA,152221984,1656,2443,4099
138868001,507 W. 10th Street,West Point,GA,31833,1012,1236,2248
136516001,999 Ave. H NE,Winter Haven,FL,338814299,3686,6905,10591
121345001,550 N COLLEGE AVE ALEXANDER HALL,CLAREMONT,CA,917116319,769,804,1573
243081001,Urb Industrial Reparada 2 #388,PONCE,PR,7162347,367,707,1074
243586001,482 S Ramon E Betances St.,MAYAGUEZ,PR,680,475,798,1273
241410001,2250 Boulevard Luis A. Ferre Aguayo,PONCE,PR,7179997,2609,4527,7136
130174001,670 Lordship Boulevard,Stratford,CT,66157158,1117,865,1982
121363001,100 E COLLEGE AVE,PORTERVILLE,CA,93257,1616,2669,4285
209746001,12000 SW 49th Avenue,Portland,OR,972197132,12403,14643,27046
209807001,PO Box 751,PORTLAND,OR,97207,11349,14362,25711
130183001,800 Country Club Road,Waterbury,CT,6723,3074,6771,9845
237701001,101 FORT AVE,KEYSER,WV,26726,583,757,1340
148007001,202 South Halsted Street,CHICAGO HEIGHTS,IL,604118226,1554,2392,3946
227526001,100 University Drive P.O. Box 519,PRAIRIE VIEW,TX,77446,3432,6084,9516
155715001,348 NE SR 61,PRATT,KS,67124,571,663,1234
194578001,200 WILLOUGHBY AVE,BROOKLYN,NY,11205,1458,3557,5015
218539001,503 South BROAD ST,CLINTON,SC,29325,577,753,1330
163657001,301 LARGO RD,LARGO,MD,207742199,4414,7471,11885
186131001,1 Nassau Hall,PRINCETON,NJ,85440070,4553,3821,8374
217402001,1 Cunningham Square,PROVIDENCE,RI,29180001,2095,2579,4674
127884001,900 West Orman,PUEBLO,CO,81004,2729,3468,6197
490805002,"2200 169th ST,",HAMMOND,IN,463232094,4560,5913,10473
243780001,610 Purdue Mall,WEST LAFAYETTE,IN,479071076,25405,19069,44474
431770001,200 BOCES DRIVE,YORKTOWN HEIGHTS,NY,105984399,,,
199412001,1900 SELWYN AVE,CHARLOTTE,NC,282740001,778,1758,2536
167525001,1250 Hancock Street,QUINCY,MA,2169,1334,2166,3500
148131001,1800 COLLEGE AVE,QUINCY,IL,623012699,555,531,1086
130217001,742 Upper Maple Street,Danielson,CT,62391436,568,767,1335
130226001,275 MOUNT CARMEL AVE,HAMDEN,CT,6518,3835,6372,10207
167534001,670 W BOYLSTON ST,WORCESTER,MA,16062092,3029,4234,7263
233277001,801 East Main St.,RADFORD,VA,24142,3657,5678,9335
186201001,505 RAMAPO VALLEY RD,MAHWAH,NJ,74301680,2624,3550,6174
199421001,629 INDUSTRIAL PARK AVE,ASHEBORO,NC,27205,1066,1718,2784
233295001,204 HENRY ST,ASHLAND,VA,230055505,701,787,1488
227687001,1100 COLLEGE CIR,RANGER,TX,76470,1106,1308,2414
178891001,4431 FINNEY AVE,SAINT LOUIS,MO,631132811,1568,130,1698
233310001,12745 College Drive,Glenns,VA,231492616,1072,2010,3082
186645001,P.O. Box 3300,Somerville,NJ,88761265,3991,3896,7887
138309001,4755 Southwest 46th Court,Ocala,FL,344746226,1436,7324,8760
448673001,6000 E. State St-Fourth Floor,Rockford,IL,611082513,180,1549,1729
175014001,226 Park Ave S,Saint Cloud,MN,563013713,684,3440,4124
215585001,10 South SECOND ST,READING,PA,196031706,1537,2662,4199
127909001,13300 W SIXTH AVE,LAKEWOOD,CO,802281255,3705,3679,7384
207069001,1300 S COUNTRY CLUB RD,EL RENO,OK,730365304,673,1256,1929
209922001,3203 SE WOODSTOCK BLVD,PORTLAND,OR,972028199,692,811,1503
117052001,995 N REED AVE,REEDLEY,CA,93654,4435,6754,11189
231651001,1000 REGENT UNIVERSITY DR,VIRGINIA BEACH,VA,23464,3716,6173,9889
167598001,235 WELLESLEY ST,WESTON,MA,24931571,426,2331,2757
127918001,3333 REGIS BLVD,DENVER,CO,802211099,2963,4944,7907
140872001,7300 REINHARDT CIR,WALESKA,GA,301832981,809,757,1566
475033001,"25 Broadway, 3rd Floor",New York,NY,10004,1015,3002,4017
148256001,468 N KEN GRAY PKY,INA,IL,628469740,1162,1324,2486
194824001,110 8TH ST,TROY,NY,121803590,5368,2527,7895
236382001,3000 NE FOURTH ST,RENTON,WA,980564195,2371,1175,3546
217420001,600 MOUNT PLEASANT AVE,PROVIDENCE,RI,29081991,2309,5457,7766
217493001,2 COLLEGE ST,PROVIDENCE,RI,2903,817,1650,2467
221351001,2000 North Parkway,Memphis,TN,381121690,899,1137,2036
227757001,6100 S MAIN,HOUSTON,TX,77005,4057,3067,7124
233338001,11301 Johnson Road,South Prince George,VA,23805,1011,1464,2475
227766001,12800 ABRAMS RD,DALLAS,TX,752432199,9162,10870,20032
148292001,One College Park,Decatur,IL,625218512,888,1588,2476
199449001,1042 W. Hamlet Ave.,Hamlet,NC,283451189,911,1644,2555
186283001,2083 LAWRENCEVILLE ROAD,LAWRENCEVILLE,NJ,86483099,1964,2860,4824
175236001,2101 15TH AVE NW,WILLMAR,MN,56201,1466,1832,3298
136774001,2700 N TAMIAMI TR,SARASOTA,FL,342345896,481,1080,1561
121886001,3600 WORKMAN MILL RD,WHITTIER,CA,906011699,11363,8634,19997
105668001,2323 W 14TH ST,Tempe,AZ,852816950,6876,11428,18304
436304001,925 W. Edenborne Parkway,Gonzales,LA,70737,1769,1701,3470
173063001,1900 8TH Ave NW,Austin,MN,55912,1485,1778,3263
121901001,4800 Magnolia Avenue,Riverside,CA,925061299,9052,12240,21292
183211001,420 SOUTH MAIN ST,NASHUA,NH,30605086,471,1848,2319
221397001,276 Patton LN,HARRIMAN,TN,37748,1873,3815,5688
233426001,221 College Lane,SALEM,VA,241533794,845,1169,2014
215655001,6001 University Blvd,MOON TOWNSHIP,PA,151081189,2637,2258,4895
148335001,401 S STATE STREET,CHICAGO,IL,60605,1042,892,1934
194958001,2301 WESTSIDE DR,ROCHESTER,NY,14624,466,1273,1739
199476001,5160 Fayetteville Rd,LUMBERTON,NC,28360,532,1139,1671
170967001,800 W AVON RD,ROCHESTER HILLS,MI,48307,425,673,1098
174738001,851 30TH AVE SE,ROCHESTER,MN,559044999,2006,3123,5129
195003001,1 LOMB MEMORIAL DR,ROCHESTER,NY,146235603,10977,5486,16463
148380001,3301 N MULFORD RD,ROCKFORD,IL,611145699,2798,3446,6244
148405001,5050 E STATE ST,ROCKFORD,IL,611082393,535,668,1203
179043001,1100 ROCKHURST RD,KANSAS CITY,MO,641102561,1272,1873,3145
199485001,HWY 65W COUNTY HOME RD,WENTWORTH,NC,273750038,639,1046,1685
195058001,145 COLLEGE RD,SUFFERN,NY,10901,3196,3663,6859
127945001,1600 Pierce Street,Lakewood,CO,80214,315,739,1054
217518001,One Old Ferry Road,Bristol,RI,2809,2334,2526,4860
207661001,1701 West Will Rogers Blvd.,Claremore,OK,740173252,1446,2187,3633
209940001,3345 REDWOOD HIGHWAY,GRANTS PASS,OR,97527,1993,2849,4842
136950001,1000 HOLT AVE,WINTER PARK,FL,327894499,1250,1877,3127
148487001,430 S MICHIGAN AVE,CHICAGO,IL,606051394,1434,2895,4329
145558001,3333 GREEN BAY RD,NORTH CHICAGO,IL,60064,935,1186,2121
207670001,6420 S E 15TH,MIDWEST CITY,OK,731102799,2745,4675,7420
152318001,5500 WABASH AVE,TERRE HAUTE,IN,478033999,1617,525,2142
445735001,11 Sunset Way,Henderson,NV,89014,694,1030,1724
183877001,601 Pemberton Browns Mills Road,Pemberton,NJ,80681599,3676,5214,8890
184791001,1400 TANYARD RD,SEWELL,NJ,8080,3071,4059,7130
184782001,201 MULLICA HILL RD,GLASSBORO,NJ,8028,10232,9233,19465
199494001,PO BOX 1595  1333 Jake Alexander Blvd,SALISBURY,NC,281451595,2298,4057,6355
167631001,1234 COLUMBUS AVE,ROXBURY CROSSING,MA,21203400,612,1395,2007
148511001,600 S. Paulina Ave,CHICAGO,IL,606123833,694,2014,2708
186371001,303 Cooper Street,CAMDEN,NJ,8102,2900,4271,7171
186380001,83 SOMERSET ST,NEW BRUNSWICK,NJ,89011281,23367,26887,50254
186399001,123 Washington Street,NEWARK,NJ,7102,6331,7120,13451
122180001,3835 FREEPORT BLVD,SACRAMENTO,CA,958221386,8794,12585,21379
130253001,5151 PARK AVE,FAIRFIELD,CT,68251000,2837,6121,8958
122205001,28000 MARGUERITE PARKWAY,MISSION VIEJO,CA,92692,8565,10856,19421
172051001,7400 BAY RD,UNIVERSITY CENTER,MI,48710,3267,5248,8515
154235001,518 W LOCUST ST,DAVENPORT,IA,528032898,1248,1797,3045
183239001,100 SAINT ANSELM DRIVE,MANCHESTER,NH,31021310,797,1227,2024
148876001,1333-45 W ARGYLE,CHICAGO,IL,606403501,284,814,1098
174783001,720 4th Avenue South,Saint Cloud,MN,563014498,6337,7591,13928
227845001,3001 S CONGRESS AVE,AUSTIN,TX,787046489,1602,2699,4301
215743001,117 Evergreen Drive,Loretto,PA,159400600,897,1714,2611
195720001,3690 EAST AVE,ROCHESTER,NY,14618,1428,2284,3712
137281001,5001 ST JOHNS AVE,PALATKA,FL,32177,2832,4671,7503
174792001,Box 2000,COLLEGEVILLE,MN,563212000,1732,45,1777
161518001,278 WHITES BRIDGE RD,STANDISH,ME,40845263,708,1398,2106
215770001,5600 City Avenue,Philadelphia,PA,19131,3190,4399,7589
137032001,33701 State Road 52,SAINT LEO,FL,335746665,4712,7096,11808
179308001,5600 Oakland,SAINT LOUIS,MO,63110,7016,11141,18157
179159001,221 N GRAND BLVD,SAINT LOUIS,MO,631032097,5757,8681,14438
236452001,5000 Abbey Way SE,LACEY,WA,985037500,798,809,1607
152381001,1 St Mary of Woods Coll,SAINT MARY-OF-THE-WOODS,IN,478761099,125,910,1035
152390001,54445 S.R. 933,NOTRE DAME,IN,465565001,22,1589,1611
123554001,1928 SAINT MARY'S ROAD,MORAGA,CA,94575,1506,2375,3881
174817001,700 Terrace Heights # 71,Winona,MN,559871399,1922,3638,5560
231059001,1 WINOOSKI PARK,COLCHESTER,VT,5439,831,1119,1950
239716001,100 GRANT ST,DE PERE,WI,541152099,924,1304,2228
175041001,235 MARSHALL AVE,SAINT PAUL,MN,551029808,3185,3727,6912
186432001,2641 KENNEDY BLVD,JERSEY CITY,NJ,73065997,1231,2221,3452
215798001,300 FRASER PURCHASE RD,LATROBE,PA,156502690,1011,856,1867
148627001,3700 W 103rd Street,Chicago,IL,606553110,1278,2389,3667
167729001,352 LAFAYETTE ST,SALEM,MA,1970,2924,5414,8338
163851001,1101 CAMDEN AVE,SALISBURY,MD,218016862,3563,5004,8567
230746001,PO BOX 30808,SALT LAKE CITY,UT,84130,13657,15499,29156
466523001,645 Shawinigan Drive,Chicopee,MA,10203744,,,
214564001,8360 OLD YORK RD,ELKINS PARK,PA,190276262,271,940,1211
217536001,100 OCHRE POINT AVE,NEWPORT,RI,28404192,893,1754,2647
227881001,1803 Ave I,HUNTSVILLE,TX,77340,7882,13331,21213
102049001,800 Lakeshore Drive,Birmingham,AL,352292240,1913,3706,5619
199625001,1801 Sunset Avenue,CLINTON,NC,28329,415,878,1293
122296001,"3100 Telegraph Avenue, Suite 1000",OAKLAND,CA,94609,522,1532,2054
227924001,1819 N. Main Ave.,SAN ANTONIO,TX,782124299,7031,10542,17573
123527001,701 S MT VERNON AVE,SAN BERNARDINO,CA,92410,5734,8103,13837
122339001,1313 PARK BLVD,SAN DIEGO,CA,921014787,6832,8234,15066
122375001,7250 MESA COLLEGE DR,SAN DIEGO,CA,921114998,10178,12106,22284
122384001,10440 BLACK MOUNTAIN RD,SAN DIEGO,CA,921262999,8363,7530,15893
122409001,5500 CAMPANILE DR,SAN DIEGO,CA,921828210,15674,19629,35303
122597001,1600 Holloway Ave,San Francisco,CA,94132,12848,16930,29778
227979001,8060 SPENCER HWY,PASADENA,TX,77505,13351,18786,32137
122658001,5151 PACIFIC AVE,STOCKTON,CA,95207,7573,10636,18209
122685001,8344 W MINERAL KING AVE,VISALIA,CA,93291,1775,3500,5275
122746001,2100 MOORPARK AVE,SAN JOSE,CA,951282798,4129,5141,9270
122755001,One Washington Square,San Jose,CA,951920001,16996,18404,35400
188100001,4601 COLLEGE BLVD,FARMINGTON,NM,874024699,2280,4399,6679
199634001,3395 AIRPORT RD,PINEHURST,NC,28374,1501,2517,4018
121619001,1530 W. 17TH STREET,SANTA ANA,CA,927063398,16881,11544,28425
122889001,721 CLIFF DR,SANTA BARBARA,CA,931092394,6742,7904,14646
122931001,500 EL CAMINO REAL,SANTA CLARA,CA,95053,4256,4386,8642
137096001,3000 NW 83RD ST,GAINESVILLE,FL,32606,6431,7893,14324
188137001,6401 RICHARDS AVE,SANTA FE,NM,875084887,1683,2524,4207
122977001,1900 PICO BL,SANTA MONICA,CA,904051628,13258,15542,28800
123013001,1501 Mendocino Avenue,Santa Rosa,CA,954014395,8989,11011,20000
399212001,8045 E CHAPMAN,ORANGE,CA,928694512,6783,4590,11373
195304001,ONE MEADWAY,BRONXVILLE,NY,107085940,431,1278,1709
148672001,173 ILLINOIS RT 2,DIXON,IL,61021,630,998,1628
140951001,342 BULL ST,SAVANNAH,GA,314023146,4618,9468,14086
140960001,3219 COLLEGE STREET,SAVANNAH,GA,31404,1602,2475,4077
140942001,5717 WHITE BLUFF RD,SAVANNAH,GA,314055521,1564,2253,3817
195322001,78 WASHINGTON AVE,SCHENECTADY,NY,12305,2296,2935,5231
143048001,37 S. Wabash Avenue,CHICAGO,IL,606033002,938,2701,3639
197151001,209 E 23RD ST,NEW YORK,NY,100103994,1308,3082,4390
172200001,18600 HAGGERTY RD,LIVONIA,MI,481522696,4454,5441,9895
228042001,2100 MEMORIAL BLVD,KERRVILLE,TX,780285697,590,828,1418
105747001,9000 E CHAPARRAL RD,SCOTTSDALE,AZ,85256,3978,4766,8744
123165001,1030 N COLUMBIA AVE,CLAREMONT,CA,917113905,10,1061,1071
236513001,1701 BROADWAY,SEATTLE,WA,981222400,2926,3876,6802
236577001,3307 3RD AVE W,SEATTLE,WA,981191997,1189,2499,3688
236595001,901 12th Avenue,SEATTLE,WA,981224340,2782,4509,7291
207740001,2701 Boren Blvd,Seminole,OK,748180351,539,1063,1602
137209001,100 Weldon Blvd,Sanford,FL,327736199,7878,10226,18104
186584001,400 S Orange Avenue,South Orange,NJ,70792697,4499,5663,10162
215947001,1 SETON HILL DR,GREENSBURG,PA,15601,788,1509,2297
221519001,735 University Avenue,Sewanee,TN,373831000,872,913,1785
155858001,1801 N. Kansas Ave.,Liberal,KS,679051137,773,1097,1870
123299001,11555 Old Oregon Trail,REDDING,CA,96003,3673,5432,9105
199643001,118 E SOUTH ST,RALEIGH,NC,27601,603,808,1411
148821001,8364 SHAWNEE COLLEGE RD,ULLIN,IL,62992,360,765,1125
205443001,940  2nd ST,PORTSMOUTH,OH,456624303,1434,1819,3253
102067001,9500 OLD GREENSBORO RD,TUSCALOOSA,AL,35405,1921,2429,4350
233541001,1460 UNIVERSITY DR,WINCHESTER,VA,226015195,1275,2542,3817
237792001,PO Box 5000,Shepherdstown,WV,254435000,1559,2089,3648
240666001,1 Whitney Way,SHERIDAN,WY,82801,2198,1970,4168
137245001,5400 SHERIDAN ST,HOLLYWOOD,FL,33021,944,857,1801
216010001,1871 Old Main Drive,Shippensburg,PA,172572299,2987,3394,6381
236610001,16101 GREENWOOD AVE N,SEATTLE,WA,981335696,2580,3369,5949
140988001,315 SHORTER AVE,ROME,GA,30165,611,841,1452
195474001,515 LOUDON RD,LOUDONVILLE,NY,122111462,1441,1780,3221
172264001,1247 SIENA HEIGHTS DR,ADRIAN,MI,49221,1014,1419,2433
123341001,5100 SIERRA COLLEGE BLVD.,ROCKLIN,CA,95677,8258,10056,18314
167783001,300 THE FENWAY,BOSTON,MA,21155898,545,5537,6082
154350001,701 NORTH C ST,INDIANOLA,IA,50125,673,771,1444
205470001,444 W THIRD ST,DAYTON,OH,454021460,7935,10641,18576
236638001,2405 East College Way,Mount Vernon,WA,982735899,2443,2716,5159
195526001,815 N BROADWAY,SARATOGA SPRINGS,NY,12866,1013,1600,2613
123509001,3300 COLLEGE DRIVE,SAN BRUNO,CA,940661698,4218,4796,9014
216038001,1 Morrow Way,SLIPPERY ROCK,PA,160571383,3645,5158,8803
167835001,ELM ST,NORTHAMPTON,MA,1063,57,2846,2903
102076001,P.O. Box 734,BOAZ,AL,359570734,867,1413,2280
230597001,150 E COLLEGE AVE,EPHRAIM,UT,84627,2442,3072,5514
110778001,1069 E. Meadow Circle,PALO ALTO,CA,94303,550,664,1214
123563001,4000 SUISUN VALLEY RD,FAIRFIELD,CA,945343197,3894,5484,9378
157711001,808 MONTICELLO STREET,SOMERSET,KY,42501,2205,3652,5857
123572001,1801 E COTATI AVE,ROHNERT PARK,CA,949283609,3595,5864,9459
107974001,300 S WEST AVE,EL DORADO,AR,717317010,436,1037,1473
218733001,300 College St. NE,Orangeburg,SC,291170001,1358,1664,3022
173911001,1920 Lee Boulevard,North Mankato,MN,560031920,1280,1466,2746
220552001,3904 Lonas Drive,KNOXVILLE,TN,379090000,645,2077,2722
219347001,501 E SAINT JOSEPH ST,RAPID CITY,SD,577013995,2005,649,2654
219356001,"Box 2201, ADM 324",Brookings,SD,570071998,5595,6509,12104
443252001,720 NW 27th Avenue 2nd. Floor,MIAMI,FL,33125,1121,303,1424
137315001,600 W COLLEGE DR,AVON PARK,FL,33825,1084,1826,2910
482699001,100 W COLLEGE PK DR,DOUGLAS,GA,315335098,870,1612,2482
141006001,900 South Ga Tech Pkwy,AMERICUS,GA,31709,982,1101,2083
434061001,1101 Bertrand Drive,Lafayette,LA,705062030,2502,3780,6282
105792001,7050 S 24TH ST,PHOENIX,AZ,85042,1679,2396,4075
197850001,680 Highway 74 West,POLKTON,NC,28135,1016,1831,2847
228158001,1401 S. COLLEGE AVE,LEVELLAND,TX,793366595,3876,5434,9310
236656001,2011 Mottman Road SW,Olympia,WA,985126292,2015,2857,4872
236504001,6000 16TH AVE SW,SEATTLE,WA,981061499,4105,2072,6177
149365001,15800 S STATE ST,SOUTH HOLLAND,IL,604731200,1559,2673,4232
409315001,3201 W PECAN,MCALLEN,TX,785029701,13878,18071,31949
156338001,1845 Loop Dr,Bowling Green,KY,421013601,1878,2604,4482
107637001,1900 Hazel St.,Pine Bluff,AR,71603,342,777,1119
181640001,8800 O Street,Lincoln,NE,685201299,4250,4990,9240
157739001,700 COLLEGE RD,CUMBERLAND,KY,40823,1753,1562,3315
179557001,ONE UNIVERSITY PLZ,CAPE GIRARDEAU,MO,637019980,4487,6584,11071
219426001,2320 N CAREER AVE,SIOUX FALLS,SD,571071301,1032,1134,2166
199759001,120 S. Wingate Street,Wake Forest,NC,275871889,2503,637,3140
154378001,1500 WEST AGENCY ROAD,WEST BURLINGTON,IA,526550180,1069,1479,2548
148937001,3575 College Road,Harrisburg,IL,62946,731,919,1650
160612001,548 Ned McGehee Avenue,HAMMOND,LA,70402,5278,9020,14298
207847001,425 W. University,Durant,OK,747010609,2052,2490,4542
368911001,3001 E FIRST ST,VIDALIA,GA,30474,535,1282,1817
137564001,1000 LONGFELLOW BLVD,LAKELAND,FL,338016034,3685,5070,8755
221661001,4881 TAYLOR CIR,COLLEGEDALE,TN,373150370,1153,1789,2942
107983001,100 E. University Street,MAGNOLIA,AR,71754,1923,2549,4472
107992001,6415 Spellman Road,Camden,AR,71701,520,562,1082
117672001,16200 E AMBER VALLEY DR,WHITTIER,CA,90604,498,713,1211
130493001,501 CRESCENT STREET,NEW HAVEN,CT,65151355,3734,6316,10050
139986001,501 VARSITY RD,GRIFFIN,GA,30223,1519,3386,4905
149222001,Anthony Hall Room 116,Carbondale,IL,629014512,6787,6030,12817
149231001,IL State Rte 157,EDWARDSVILLE,IL,620261001,6018,7263,13281
161545001,2 FORT RD,SOUTH PORTLAND,ME,41061698,2639,3213,5852
228246001,6425 BOAZ ST,DALLAS,TX,752750221,6041,5608,11649
206862001,6729 NW 39TH EXPY,BETHANY,OK,73008,977,1104,2081
183026001,2500 N RIVER RD,MANCHESTER,NH,3106,36727,67341,104068
210146001,1250 SISKIYOU BLVD,ASHLAND,OR,97520,2196,4082,6278
487162001,15689 US Hwy 19 North,Thomasville,GA,31792,1573,3064,4637
205966001,351 Brooks-Malott Road,Mount Orab,OH,45154,851,1604,2455
481322001,601 East Nolana Suite C,McAllen,TX,785042569,,,
251260001,750 ROBERTS ST,WADLEY,AL,36276,1980,2551,4531
160621001,Southern Branch Post Office,BATON ROUGE,LA,70813,2349,4344,6693
160630001,6400 Press Drive,New Orleans,LA,70126,629,1727,2356
160649001,3050 MARTIN LUTHER KING DRIVE,SHREVEPORT,LA,71107,775,1876,2651
230603001,351 West University Blvd.,CEDAR CITY,UT,84720,4311,5885,10196
233611001,ONE UNIVERSITY HILL DR,BUENA VISTA,VA,24416,483,540,1023
217776001,907 WESLEYAN DR,CENTRAL,SC,296301020,535,1016,1551
237817001,2900 DEMPSEY BRANCH ROAD,MOUNT GAY,WV,25637,484,974,1458
233639001,109 CAMPUS DR,ALBERTA,VA,23821,1230,2200,3430
179326001,1600 UNIVERSITY AVE,BOLIVAR,MO,656132596,1241,2116,3357
175078001,1501 STATE ST,MARSHALL,MN,56258,2845,4322,7167
176354001,1156 COLLEGE DRIVE,SUMMIT,MS,396660000,768,1257,2025
221485001,5983 Macon Cove,Memphis,TN,381347693,3412,5935,9347
228316001,2401 GARNER FIELD RD,UVALDE,TX,788016297,2838,4056,6894
451556001,1414 Geronimo,El Paso,TX,79925,610,871,1481
233648001,P.O. Box 1101,RICHLANDS,VA,246411101,842,1531,2373
239910001,1800 BRONSON BLVD,FENNIMORE,WI,538099778,842,1167,2009
228325001,1200 SYCAMORE,WAXAHACHIE,TX,75165,992,1110,2102
123800001,900 OTAY LAKES ROAD,CHULA VISTA,CA,91910,8621,9948,18569
154396001,1501 West Townline Street,CRESTON,IA,50801,632,915,1547
143215001,2500 Carlyle Ave,Belleville,IL,622215899,3943,4898,8841
172307001,58900 CHERRY GROVE RD,DOWAGIAC,MI,490479793,865,1265,2130
207865001,100 CAMPUS DR,WEATHERFORD,OK,730963098,2052,3215,5267
210155001,1988 NEWMARK AVE,COOS BAY,OR,974202912,931,1226,2157
228343001,1001 UNIVERSITY AVE,GEORGETOWN,TX,78626,645,789,1434
160579001,3749 J BENNETT JOHNSTON AVE,LAKE CHARLES,LA,70615,1752,1707,3459
157757001,845 South Third Street,LOUISVILLE,KY,402032188,471,1287,1758
218830001,107 Community College Drive,SPARTANBURG,SC,29305,1905,2629,4534
141060001,350 SPELMAN LN SW,ATLANTA,GA,303144399,0,2171,2171
236692001,1810 NORTH GREENE STREET,Spokane,WA,992175399,4358,6017,10375
236708001,3410 W FORT GEORGE WRIGHT DRIVE,SPOKANE,WA,992245288,2163,3021,5184
148991001,23235 N CO 22,CANTON,IL,615209801,539,897,1436
172334001,106 E. MAIN ST,SPRING ARBOR,MI,492839799,838,2598,3436
102234001,4000 DAUPHIN ST,MOBILE,AL,366081791,563,816,1379
167899001,263 ALDEN ST,SPRINGFIELD,MA,11093797,1347,1792,3139
167905001,1 ARMORY SQ,SPRINGFIELD,MA,11051296,2034,2887,4921
195164001,3261 West State Road,SAINT BONAVENTURE,NY,14778,1176,1203,2379
175005001,2004 RANDOLPH AVE,SAINT PAUL,MN,55105,308,4551,4859
262031001,4601 Mid Rivers Mall Drive,Cottleville,MO,633762865,2673,3596,6269
172291001,323 Erie,Port Huron,MI,480615015,1326,2215,3541
174756001,1540 Northway Drive,Saint Cloud,MN,563031240,1942,2383,4325
195173001,180 Remsen Street,Brooklyn,NY,11201,952,1461,2413
195809001,8000 UTOPIA PKY,JAMAICA,NY,11439,8920,12715,21635
195216001,23 Romoda Drive,CANTON,NY,13617,1128,1394,2522
163912001,18952 E. Fisher Road,Saint Mary's City,MD,206863001,663,919,1582
174844001,1520 ST OLAF AVE,NORTHFIELD,MN,550571098,1296,1752,3048
137078001,"6021 142 Ave North,",Largo,FL,33760,11223,17960,29183
227854001,1801 MARTIN LUTHER KING DR,SAN ANTONIO,TX,782032098,5051,6539,11590
137476001,16401 NW 37th  AVE,MIAMI GARDENS,FL,330546459,1779,2448,4227
195562002,155 W. Roe Blvd,Patchogue,NY,11772,1222,2893,4115
195544001,245 CLINTON AVE,BROOKLYN,NY,112053688,351,828,1179
179265001,4588 PARKVIEW PL,SAINT LOUIS,MO,631101088,465,730,1195
228149001,ONE CAMINO SANTA MARIA,SAN ANTONIO,TX,782288572,1665,1983,3648
195243001,125 RTE 340,SPARKILL,NY,109761050,933,1067,2000
446561001,2041 BUSINESS CTR DR STE 107,IRVINE,CA,92612,348,1043,1391
243744001,450 Jane Stanford Way Building 10,STANFORD,CA,943052061,9630,7751,17381
199740001,141 COLLEGE DRIVE,ALBEMARLE,NC,28001,803,1742,2545
205841001,6200 FRANK AVE NW,NORTH CANTON,OH,44720,4769,6885,11654
135391001,5840 26TH ST W,BRADENTON,FL,34207,3825,6404,10229
179539001,3201 W 16TH STREET,SEDALIA,MO,653012199,1783,2948,4731
177977001,One Technology Dr.,Linn,MO,650519607,1187,284,1471
196176001,1 Hawk Drive,NEW PALTZ,NY,12561,2826,4782,7608
228431001,1936 North St.,Nacogdoches,TX,759623062,4667,8477,13144
137546001,421 N WOODLAND BLVD,DELAND,FL,32723,1881,2460,4341
186867001,1 CASTLE POINT TERRACE,HOBOKEN,NJ,70305991,4910,2019,6929
164173001,1525 GREENSPRING VALLEY RD,STEVENSON,MD,211530641,1220,2395,3615
186876001,101 Vera King Farris Drive,Galloway,NJ,82059441,3859,5762,9621
167996001,320 WASHINGTON ST,EASTON,MA,23577180,1028,1528,2556
196097001,100 Nicolls Road,STONY BROOK,NY,11794,12716,13540,26256
438498001,7777 LEESBURG PIKE,FALLS CHURCH,VA,220432403,690,1406,2096
450377001,3570 Grandview Pkwy Ste 200,Birmingham,AL,35243,266,968,1234
449038002,"5650 Breckenridge Park Drive, Suite 300",Tampa,FL,33610,701,1504,2205
458919001,"3355 Northeast Expwy, Ste 100",Atlanta,GA,30341,1635,5895,7530
430184001,5110 Auth Way,Suitland,MD,20746,867,2314,3181
453163001,4 Copley Parkway,Morrisville,NC,27560,1133,4570,5703
443784001,3800 Horizon Blvd Ste 100,Feasterville Trevose,PA,19053,561,1700,2261
458964001,"777 Lowndes Hill Road Building 3, Suite 300",Greenville,SC,29607,499,2188,2687
443766001,2620 Thousand Oaks Blvd Ste 1100,Memphis,TN,38118,532,2549,3081
458973001,8501 North Mopac Expy Ste 100,Austin,TX,78759,675,1742,2417
233684001,2121 15th Street N,Arlington,VA,22201,2034,3486,5520
366395001,533 COLLEGE RD,SELDEN,NY,11784,12152,13926,26078
168005001,8 ASHBURTON PL BEACON HILL,BOSTON,MA,2108,3151,4035,7186
228501001,400 North Harrison,ALPINE,TX,79832,1121,1618,2739
195988001,112 College Rd,LOCH SHELDRAKE,NY,127595151,694,840,1534
157793001,3101 Bardstown Road,Louisville,KY,402053013,1385,2190,3575
137120001,4748 BENEVA RD,SARASOTA,FL,34233,651,451,1102
196060001,1400 WASHINGTON AVE,ALBANY,NY,12222,8349,9595,17944
196158001,CENTRAL AVE,FREDONIA,NY,14063,1939,2716,4655
196219001,735 ANDERSON HILL RD,PURCHASE,NY,10577,1770,2464,4234
189547001,907 Upper Front Street,Binghamton,NY,13905,2791,3716,6507
196130001,1300 ELMWOOD AVE,BUFFALO,NY,142221095,3810,5308,9118
196121001,350 NEW CAMPUS DR,BROCKPORT,NY,14420,3433,4854,8287
196167001,1 College Circle,Geneseo,NY,144541477,2162,3450,5612
196237001,"PO Box 210,  223 Store Hill Road",Old Westbury,NY,115680210,2046,3041,5087
196194001,Route 104 West,OSWEGO,NY,13126,3909,4077,7986
196246001,101 Broad Street,PLATTSBURGH,NY,12901,2389,3315,5704
196200001,Pierrepont Avenue,Potsdam,NY,136762294,1390,2131,3521
196033001,State Rt 7,COBLESKILL,NY,12043,1071,1207,2278
196103001,ONE FORESTRY DR,SYRACUSE,NY,13210,1161,1059,2220
196006001,10 Upper College Drive,ALFRED,NY,14802,2332,1405,3737
196015001,34 CORNELL DR,CANTON,NY,136171037,1384,1829,3213
196024001,2 Main Street,DELHI,NY,13753,1457,1775,3232
196149001,PO BOX 2000,CORTLAND,NY,13045,2941,3917,6858
196255001,450 CLARKSON AVE,BROOKLYN,NY,11203,680,1166,1846
196264001,2 UNION AVE,SARATOGA SPRINGS,NY,12866,3862,6562,10424
196291001,6 PENNYFIELD AVE,BRONX,NY,10465,1500,234,1734
196185001,RAVINE PKY,ONEONTA,NY,13820,2418,4125,6543
196112001,100 Seymour Road,UTICA,NY,13502,1814,1209,3023
197294001,75 GRASSLANDS RD,VALHALLA,NY,10595,5453,6082,11535
199768001,630 S. MAIN ST.,DOBSON,NC,27017,1184,1889,3073
216278001,514 UNIVERSITY AVE,SELINSGROVE,PA,178701025,1034,1362,2396
247603001,One Colleg Hill Road,Newton,NJ,7860,1157,1143,2300
216287001,500 COLLEGE AVE,SWARTHMORE,PA,190811397,766,793,1559
196413001,900 S. Crouse Ave.,SYRACUSE,NY,13244,10903,11900,22803
236753001,6501 S 19TH ST,TACOMA,WA,984666100,2266,3976,6242
124113001,29 Cougar Court,Taft,CA,932682329,3489,2666,6155
102298001,627 W BATTLE ST,TALLADEGA,AL,35160,611,601,1212
137759001,444 APPLEYARD DR,TALLAHASSEE,FL,323042895,5452,6462,11914
228529001,1333 W. Washington,STEPHENVILLE,TX,764020000,4963,8146,13109
228547002,5301 Campus Drive,Fort Worth,TX,761195998,20922,30178,51100
152530001,236 W READE AVE,UPLAND,IN,469891001,984,1211,2195
196468001,525 W 120TH ST,NEW YORK,NY,100276696,974,3575,4549
217712001,921 Ribaut Road,Beaufort,SC,299011288,726,1521,2247
228608001,2600 S 1ST ST,TEMPLE,TX,765047435,1681,3230,4911
216339001,1801 N. BROAD STREET,PHILADELPHIA,PA,191226096,18314,21426,39740
220640001,740 HI TECH DR,LIVINGSTON,TN,38570,733,526,1259
221838001,3500 JOHN MERRITT BLVD.,NASHVILLE,TN,372091561,2864,4910,7774
221847001,1 William L. Jones Drive,COOKEVILLE,TN,385050001,5482,4704,10186
221731001,204 EAST COLLEGE STREET,ATHENS,TN,37303,373,635,1008
206011001,2830 NAPOLEON RD,FREMONT,OH,434209670,1111,1117,2228
228699001,2500 N ROBISON RD,Texarkana,TX,75599,1576,2663,4239
226152001,5201 University Boulevard,Laredo,TX,780411900,3074,4810,7884
483036001,1001 Leadership Place,Killeen,TX,76549,1017,1447,2464
228723001,Main Campus,COLLEGE STATION,TX,77843,36450,32229,68679
224554001,2600 South Neal,COMMERCE,TX,754283011,4751,7660,12411
224147001,6300 Ocean Dr.,Corpus Christi,TX,784125503,4708,7221,11929
228705001,700 UNIVERSITY BLVD,KINGSVILLE,TX,78363,4388,4153,8541
459949004,One University Way,San Antonio,TX,78224,2510,4047,6557
224545001,7101 University Ave.,TEXARKANA,TX,75503,839,1258,2097
228875001,2800 S UNIVERSITY DR,FORT WORTH,TX,76129,4508,6410,10918
228884001,2404 N. GRAND AVENUE,Tyler,TX,757021962,571,471,1042
228981001,1000 W. COURT ST,SEGUIN,TX,781555999,717,726,1443
229063001,3100 CLEBURNE ST,HOUSTON,TX,77004,4068,5664,9732
227377001,80 Fort Brown,BROWNSVILLE,TX,78520,3155,3975,7130
487320002,3801 Campus Dr.,Waco,TX,76705,8483,3962,12445
228459001,601 UNIVERSITY DR,SAN MARCOS,TX,786664684,16045,22599,38644
229115001,"150 Administration Building, Box 42005",LUBBOCK,TX,794092005,19926,18283,38209
229337001,"3601 4th Street, Stop 6258",Lubbock,TX,794306258,1398,3685,5083
229160001,1201 WESLEYAN ST,FORT WORTH,TX,761051536,963,1273,2236
229179001,304 Administration Dr.,Denton,TX,762045798,1882,13636,15518
216296001,750 E KING ST,LANCASTER,PA,17602,1104,129,1233
138813001,"6600 PEACHTREE DUNWOODY RD, 100 EMBASSY ROW",ATLANTA,GA,303281635,660,586,1246
143978001,325 N. Wells Street,CHICAGO,IL,60654,269,940,1209
455664001,707 Wilshire Boulevard,Los Angeles,CA,90017,509,2119,2628
461157001,541 Avenue of the Americas,New York,NY,100112026,,,
392257001,240 Northwest Mall Boulevard,HOUSTON,TX,77092,116,1436,1552
187134001,2000 Pennington Road,Ewing,NJ,86280718,3197,4489,7686
195234001,432 WESTERN AVE,ALBANY,NY,122031490,1148,2835,3983
174899001,1200 KENWOOD AVE,DULUTH,MN,558114199,1107,2936,4043
206589001,1189 Beall Avenue,Wooster,OH,44691,919,1085,2004
235167001,2700 EVERGREEN PKY NW,OLYMPIA,WA,98505,1357,1970,3327
117751001,21726 Placerita Canyon Road,Santa Clarita,CA,913211200,1297,760,2057
193654001,66 W 12 ST,NEW YORK,NY,10011,2931,7613,10544
195128001,65 First St.,TROY,NY,12180,540,2093,2633
100751001,1110 Jackson Ave,TUSCALOOSA,AL,354870180,16706,21684,38390
202763001,1000 N MAIN ST,FINDLAY,OH,458403695,1728,3142,4870
180489001,32 Campus Drive,MISSOULA,MT,598128928,4689,6273,10962
180692001,710 S ATLANTIC,DILLON,MT,597253598,536,972,1508
137847001,401 West Kennedy Blvd.,Tampa,FL,336061490,3890,5443,9333
221740001,615 MCCALLIE AVE,CHATTANOOGA,TN,374032598,5068,6570,11638
487010002,"220 Hyman Administration Building, 62 S. Dunlap",Memphis,TN,38163,1253,2027,3280
221759001,831 Andy Holt Tower,Knoxville,TN,379960180,14042,14852,28894
221768001,UNIVERSITY ST.,MARTIN,TN,38238,2802,4246,7048
228769001,701 S NEDDERMAN DR,ARLINGTON,TX,76019,17896,30003,47899
228778001,Main Building Suite 400,Austin,TX,78712,24520,27312,51832
228787001,800 W. Campbell Rd AD22,RICHARDSON,TX,75080,16319,12436,28755
228796001,500 W UNIVERSITY AVE,EL PASO,TX,799680691,11546,13605,25151
229027001,One UTSA Circle,San Antonio,TX,78249,15871,16393,32264
228802001,3900 UNIVERSITY BLVD,TYLER,TX,757990001,4152,6054,10206
229300001,"7000 FANNIN, SUITE 1200",HOUSTON,TX,77030,1659,3676,5335
228644001,7703 FLOYD CURL DR,SAN ANTONIO,TX,782293900,1288,2004,3292
228653001,301 UNIVERSITY BLVD.,GALVESTON,TX,77555,1013,2330,3343
229018001,4901 E UNIVERSITY Blvd,ODESSA,TX,797620001,2392,3442,5834
227368001,1201 W. University Dr.,Edinburg,TX,785392999,12156,16488,28644
215105001,320 S BROAD ST,PHILADELPHIA,PA,19102,711,1203,1914
233897001,1 COLLEGE AVE,WISE,VA,24293,788,1277,2065
138354001,11000 UNIVERSITY PKWY,Pensacola,FL,325145750,5122,7725,12847
161563001,180 W RIVER RD,WATERVILLE,ME,49015097,811,956,1767
187046001,111 W STATE ST,TRENTON,NJ,8608,6170,4764,10934
216366001,925 Chestnut Street,PHILADELPHIA,PA,191075587,2435,5351,7786
157809001,333 THOMAS MORE PARKWAY,CRESTVIEW HILLS,KY,410173495,1078,1175,2253
233754001,99 Thomas Nelson Drive,Hampton,VA,23666,3133,4552,7685
141167001,1501 MILLPOND RD,THOMASVILLE,GA,31792,420,890,1310
179645001,2080 THREE RIVERS BLVD,POPLAR BLUFF,MO,63901,996,2080,3076
129808001,574 NEW LONDON TURNPIKE,NORWICH,CT,63606598,1584,2413,3997
233772001,300 Granby Street,Norfolk,VA,235101910,8434,12507,20941
206048001,155 MIAMI ST,TIFFIN,OH,44883,1455,1590,3045
141185001,107 Kincaid Dr. Msc 777,TOCCOA FALLS,GA,30598,705,951,1656
196565001,170 NORTH ST,DRYDEN,NY,13053,1032,1341,2373
196592001,320 W. 31 Street,NEW YORK,NY,10010,3564,8236,11800
459736001,1310 Club Drive,Vallejo,CA,94592,580,855,1435
459824001,874 American Pacific Drive,Henderson,NV,89014,651,828,1479
459727001,"10601 Calle Lee, Suite 179",Los Alamitos,CA,90720,477,1195,1672
164076001,8000 YORK RD,TOWSON,MD,212520001,8860,14063,22923
210234001,650 College Blvd.,Ontario,OR,97914,843,1023,1866
221892001,333 MURFREESBORO RD,NASHVILLE,TN,37210,1344,2583,3927
218885001,7900 U.S. Hwy 76,PENDLETON,SC,29670,2952,3130,6082
460747001,"28 North Clark Street, 5th Floor",Chicago,IL,606022716,,,
218894001,7000 Rivers Avenue,North Charleston,SC,29406,4794,7354,12148
152567001,1 UNIVERSITY AVE,ANGOLA,IN,467031764,2346,1974,4320
128258001,600 Prospect St,Trinidad,CO,81082,625,917,1542
149505001,6601 W COLLEGE DR,PALOS HEIGHTS,IL,604630929,362,769,1131
130590001,300 SUMMIT ST,HARTFORD,CT,61063100,1122,1113,2235
149514001,2065 HALF DAY RD,DEERFIELD,IL,600151283,1179,596,1775
229267001,One Trinity Place,SAN ANTONIO,TX,782127200,1236,1401,2637
225308001,100 Cardinal Drive,ATHENS,TX,75751,1767,2478,4245
131876001,"125 Michigan Avenue, N.E.",Washington,DC,200171094,114,1668,1782
149532001,2000 5th Ave.,River Grove,IL,60171,4718,5811,10529
196653001,360 CHOATE AVE,BUFFALO,NY,142202094,222,1127,1349
102368001,University Avenue,TROY,AL,360820001,6336,10645,16981
182500001,7000 Dandini Blvd.,Reno,NV,895123999,5064,5797,10861
141237001,100 ALUMNI DR,CLEVELAND,GA,30528,1377,1624,3001
178615001,100 E NORMAL,KIRKSVILLE,MO,635014221,2336,3517,5853
168148001,419 Boston Avenue,Medford,MA,21555555,5111,6475,11586
160755001,6823 ST CHARLES AVE,NEW ORLEANS,LA,701185698,5303,7343,12646
207935001,909 South Boston Avenue,TULSA,OK,74119,6152,10323,16475
488934002,3850 N Peoria,Tulsa,OK,74106,2275,1795,4070
486798001,243A Greens Road,Houston,TX,770602100,1319,99,1418
130606001,271 Scott Swamp Road,FARMINGTON,CT,60323187,1708,2194,3902
221953001,60 Shiloh Road,Greeneville,TN,37743,764,971,1735
102377001,"Kresge Center, 3rd Floor RM 310 Tuskegee Univ.",Tuskegee,AL,360881920,1079,1947,3026
229355001,1400 EAST FIFTH ST,TYLER,TX,75701,3882,6224,10106
397942001,3602 N. Blackstone Ave. Ste. 0268,FRESNO,CA,93726,421,579,1000
230676001,1100 E LAGOON ST 124-5,ROOSEVELT,UT,84066,828,385,1213
196699001,491 COTTEKILL ROAD,STONE RIDGE,NY,12484,1690,1864,3554
441371001,1255 Cleveland Street,CLEARWATER,FL,33755,1116,17777,18893
210270001,1140 College Rd.,Roseburg,OR,974700226,1067,1636,2703
157863001,310 COLLEGE ST,BARBOURVILLE,KY,409061499,620,713,1333
187198001,1033 SPRINGFIELD AVE,CRANFORD,NJ,70161599,3577,5835,9412
221971001,1050 UNION UNIVERSITY DR,JACKSON,TN,383059901,1066,2181,3247
197027001,300 STEAMBOAT RD,KINGS POINT,NY,110241699,831,184,1015
197018001,191 Rodney St,BROOKLYN,NY,11211,2756,0,2756
459204001,4670 Auto Mall Pkwy,Fremont,CA,94538,693,3081,3774
460543001,5151 Regents Boulevard,Irving,TX,75063,1211,55,1266
106041001,10695 West Pierce Street,Avondale,AZ,85323,1773,96,1869
438504001,9494 Haven Avenue,RANCHO CUCAMONGA,CA,91730,1305,57,1362
448433001,4100 Duckhorn Drive,Sacramento,CA,95834,1222,56,1278
445799001,750 Pennsylvania Drive,Exton,PA,19341,1050,36,1086
229416001,721 LOCKHAVEN DR,HOUSTON,TX,77073,1378,48,1426
369400001,9751 DELEGATES DR,ORLANDO,FL,32837,1997,84,2081
241191001,CARR 106 KM 2.2 INT,MAYAGUEZ,PR,6800118,480,773,1253
241225001,Avenida Zaya Verde Reparto La Milagrosa,Bayamon,PR,9591725,492,907,1399
243346001,"CARR. # 190 Km. 1.8, BO. SABANA ABAJO",CAROLINA,PR,9842010,3831,6499,10330
243443001,CALLE ROSALES  PDA 26 1/2,SANTURCE,PR,909,1695,2774,4469
243601001,CARR. # 189 KM 3.3,GURABO,PR,7783030,6174,9525,15699
241739001,1399 AVE. ANA G. MENDEZ KM 0.3,CUPEY,PR,9281150,4076,7520,11596
243577001,377 PONCE DE LEON AVE,HATO REY,PR,918,3146,1085,4231
196088001,CAPEN HALL,BUFFALO,NY,142604900,17053,14450,31503
200800001,302 BUCHTEL COMMON,AKRON,OH,443254702,9675,9056,18731
200846001,1901 SMUCKER RD,ORRVILLE,OH,44667,713,970,1683
100663001,"ADMINISTRATION BLDG SUITE 1070, 701 20th Street So",BIRMINGHAM,AL,352940110,8363,13560,21923
100706001,301 SPARKMAN DR,HUNTSVILLE,AL,35899,5421,4315,9736
102553001,3211 Providence Dr,Anchorage,AK,99508,5972,8672,14644
102614001,P.O. Box 757500,FAIRBANKS,AK,997757480,3013,4391,7404
102632001,11066 Auke Lake Way,JUNEAU,AK,99801,776,1490,2266
104179001,1200 E. Univeristy,TUCSON,AZ,857210021,20993,23104,44097
106397001,ADMINISTRATION BLDG 422,FAYETTEVILLE,AR,727011201,13086,14692,27778
106245001,2801 S UNIVERSITY AVE,LITTLE ROCK,AR,72204,3951,6564,10515
106485001,Highway 425 South,Monticello,AR,71656,1330,1781,3111
106412001,1200 N UNIVERSITY MAIL SLOT 4789,PINE BLUFF,AR,716014789,1078,1501,2579
106999001,"2005 White Drive, PO BOX 3350",Batesville,AR,725033350,425,894,1319
107725001,2500 S MAIN,HOPE,AR,71801,519,1040,1559
107585001,1537 University Blvd.,MORRILTON,AR,72110,700,1202,1902
106263001,4301 W MARKHAM SLOT 583,LITTLE ROCK,AR,72205,879,1879,2758
108092001,5210 Grand Ave,Fort Smith,AR,729133649,2832,3725,6557
107664001,3000 W SCENIC DR,NORTH LITTLE ROCK,AR,72118,1657,2874,4531
161873001,1420 North Charles Street,Baltimore,MD,21201,2009,3032,5041
128744001,126 Park Avenue,Bridgeport,CT,6604,2030,3455,5485
110635001,Rm. 1 Sproul Hall,Berkeley,CA,947201199,20866,21635,42501
110644001,One Shields Avenue,DAVIS,CA,956168678,15539,22628,38167
110398001,200 McALLISTER ST.,SAN FRANCISCO,CA,941024707,408,594,1002
110653001,"University of California, Irvine",IRVINE,CA,92697,17798,18234,36032
110662001,405 HILGARD AVE,LOS ANGELES,CA,900951364,20197,24340,44537
445188001,5200 North Lake Road,Merced,CA,95343,4166,4378,8544
110671001,900 University Avenue,Riverside,CA,92521,11327,12595,23922
110680001,9500 Gilman Dr Mail Code 0005,La Jolla,CA,920930005,19806,18081,37887
110699001,500 Parnassus Ave,San Francisco,CA,941430402,1157,1957,3114
110705001,574 Public Safety Building,SANTA BARBARA,CA,931061010,12148,13828,25976
110714001,1156 HIGH ST,SANTA CRUZ,CA,95064,10245,9455,19700
106704001,201 DONAGHEY AVE,CONWAY,AR,720350001,4268,6909,11177
132903001,4000 Central Florida Blvd.,ORLANDO,FL,32816,30834,37641,68475
176965001,306 Broad Street,Warrensburg,MO,64093,4957,6530,11487
206941001,100 N UNIVERSITY DR,EDMOND,OK,730345209,6145,9248,15393
237312001,2300 MACCORKLE AVE SE,CHARLESTON,WV,25304,1504,1119,2623
144050001,5801 S ELLIS AVE,CHICAGO,IL,60637,9348,7654,17002
201955001,9555 PLAINFIELD RD,BLUE ASH,OH,45236,2000,2870,4870
201946001,4200 CLERMONT COLLEGE DR,BATAVIA,OH,45103,1312,1705,3017
201885001,2624 CLIFTON AVENUE,CINCINNATI,OH,452210127,17859,20027,37886
126614001,Campus Box 17 UCB,Boulder,CO,803090017,20308,16373,36681
126580001,1420 AUSTIN BLUFFS PKWY,COLORADO SPRINGS,CO,80918,6174,6949,13123
126562001,1380 Lawrence Street,DENVER,CO,80204,10813,14832,25645
129020001,126 North Eagleville Road,STORRS,CT,62693070,13325,14087,27412
463056001,10 Prospect Street,Hartford,CT,6103,694,738,1432
436836001,One University Place,STAMFORD,CT,69012315,990,987,1977
224323001,1845 E NORTHGATE,IRVING,TX,750624736,1321,1221,2542
202480001,300 COLLEGE PK,DAYTON,OH,454690001,5820,5421,11241
130943001,413 Academy St.,NEWARK,DE,19716,10588,13532,24120
127060001,2199 S. UNIVERSITY BLVD.,DENVER,CO,80208,5013,6939,11952
169716001,4001 W McNichols Rd,DETROIT,MI,48221,2092,3019,5111
153278001,2000 UNIVERSITY AVE,DUBUQUE,IA,520015099,1282,1103,2385
150534001,1800 LINCOLN AVE,EVANSVILLE,IN,47722,999,1444,2443
134130001,University of Florida,Gainesville,FL,32611,23093,29125,52218
139959001,The University of Georgia,ATHENS,GA,30602,16451,22201,38652
240754001,"303 University Drive, UOG Station",Mangilao,GU,96923,1584,2160,3744
129525001,200 BLOOMFIELD AVE,WEST HARTFORD,CT,61171599,3167,3603,6770
141565001,200 W KAWILI ST,HILO,HI,967204091,1194,2212,3406
141574001,2500 Campus Road,Honolulu,HI,96822,7502,10208,17710
141839001,310 W. KA'AHUMANU AVE,KAHULUI,HI,967321617,974,2118,3092
141981001,91-1001 Farrington Hwy,Kapolei,HI,96707,1024,2104,3128
160065001,4123 WOODLAND DR,NEW ORLEANS,LA,701317399,218,1037,1255
225511001,4800 CALHOUN,HOUSTON,TX,772042162,22958,23366,46324
225414001,2700 BAY AREA BLVD,HOUSTON,TX,770581098,3353,5608,8961
225432001,1 MAIN ST,HOUSTON,TX,770021014,5657,8608,14265
225502001,3007 N. Ben Wilson,Victoria,TX,779015731,1497,2839,4336
142285001,875 Perimeter Dr MS 2285,MOSCOW,ID,838442285,6059,5782,11841
145600001,"601 S. Morgan St., Suite 2801, M/C102",Chicago,IL,60607,14658,17025,31683
148654001,One University Plaza,Springfield,IL,627949243,2322,2253,4575
145637001,601 E John Street,Champaign,IL,61820,26907,22795,49702
151263001,1400 E HANNA AVE,INDIANAPOLIS,IN,462273697,1989,3946,5935
153658001,JESSUP HALL,IOWA CITY,IA,522421316,14867,16789,31656
200156001,6000 College Lane,JAMESTOWN,ND,58405,523,566,1089
155317001,1450 Jayhawk Boulevard,LAWRENCE,KS,66045,12997,14693,27690
157085001,104 Administration Drive,LEXINGTON,KY,405060032,12928,16254,29182
117140001,1950 THIRD ST,LA VERNE,CA,917504401,3056,5008,8064
160658001,104 UNIVERSITY CIR,LAFAYETTE,LA,70503,7321,9802,17123
159993001,700 UNIVERSITY AVE,MONROE,LA,71209,3225,6066,9291
157289001,2301 S 3RD ST,LOUISVILLE,KY,402920001,10140,11290,21430
232609001,1501 LAKESIDE DR,LYNCHBURG,VA,245013199,1148,1933,3081
161253001,168 College Ave,ORONO,ME,4469,5638,5766,11404
161217001,46 UNIVERSITY DR,AUGUSTA,ME,43309410,1253,2875,4128
161226001,224 MAIN ST,FARMINGTON,ME,4938,626,1414,2040
161235001,23 University Drive,FORT KENT,ME,47431292,520,1271,1791
161341001,181 Main Street,PRESQUE ISLE,ME,47692888,608,945,1553
200217001,7500 UNIVERSITY DRIVE,BISMARCK,ND,58504,1424,2372,3796
226471001,900 COLLEGE ST,BELTON,TX,765132599,1373,2515,3888
232681001,1301 COLLEGE AVE,FREDERICKSBURG,VA,224015358,1675,3052,4727
163338001,30665 Student Service Lane,PRINCESS ANNE,MD,218531299,1377,1816,3193
163268001,1000 Hilltop Circle,Baltimore,MD,21250,7536,6231,13767
163286001,US Route 1,COLLEGE PARK,MD,20742,21681,19519,41200
163204001,3501 University Blvd East,Adelphi,MD,207838010,31919,28684,60603
163259001,220 Arch Street,Baltimore,MD,21201,1799,4978,6777
166708001,55 Lake Avenue North,Worcester,MA,16550002,450,735,1185
166629001,374 Whitmore Administration Building,Amherst,MA,1003,15341,15252,30593
166638001,100 MORRISSEY BLVD,BOSTON,MA,21253393,6915,9249,16164
167987001,285 OLD WESTPORT RD,NORTH DARTMOUTH,MA,27472300,4250,4263,8513
166513001,1 UNIVERSITY AVE,LOWELL,MA,18545104,10964,7278,18242
220862001,3720 Alumni,MEMPHIS,TN,38152,8762,12696,21458
135726001,"5665 Ponce De Leon Boulevard, Office # 116",Coral Gables,FL,33146,8180,9151,17331
170976001,503 Thompson St,ANN ARBOR,MI,48109,23632,23084,46716
171137001,4901 EVERGREEN RD,DEARBORN,MI,481282406,5371,4089,9460
171146001,303 E KEARSLEY,FLINT,MI,485021950,2855,4677,7532
174075001,105 SELVIG HALL,CROOKSTON,MN,56716,1256,1554,2810
174233001,1049 University Drive,Duluth,MN,55812,5670,5354,11024
174251001,600 EAST 4TH STREET,MORRIS,MN,562672132,666,886,1552
174066001,100 CHURCH STREET SE,MINNEAPOLIS,MN,554550213,23462,27272,50734
176017001,Kinard Hall Wing C,UNIVERSITY,MS,386771848,9732,12724,22456
178396001,105 JESSE HALL,COLUMBIA,MO,65211,13688,16155,29843
178402001,5100 ROCKHILL RD,KANSAS CITY,MO,641102499,7018,9357,16375
178420001,1 University Blvd.,Saint Louis,MO,631214400,6816,9625,16441
101693001,5735 College Parkway,MOBILE,AL,366132842,635,1250,1885
101709001,STATION 6001,MONTEVALLO,AL,35115,820,1792,2612
199069001,634 HENDERSON ST,MOUNT OLIVE,NC,283650919,1132,2076,3208
204185001,1972 CLARK AVE,ALLIANCE,OH,44601,1278,1125,2403
181215001,905 W 25TH ST,KEARNEY,NE,688491212,2428,3899,6327
181394001,6001 DODGE ST,OMAHA,NE,681820225,6940,8491,15431
181428001,984230 NEBRASKA MEDICAL CTR,OMAHA,NE,681984230,1407,2565,3972
181464001,14th and R St,Lincoln,NE,685880419,13452,12368,25820
182281001,4505 S. Maryland Parkway,Las Vegas,NV,89154,13100,17357,30457
182290001,1664 N. Virginia Street,Reno,NV,895570250,10015,11448,21463
161457001,11 HILLS BEACH RD,BIDDEFORD,ME,4005,2382,5628,8010
183044001,THOMPSON HALL,DURHAM,NH,38243547,6901,8397,15298
129941001,300 Boston Post Rd.,WEST HAVEN,CT,6516,3255,3612,6867
187958001,705 Gurley Dr.,Gallup,NM,87301,801,1389,2190
187985001,2500 Campus Blvd. NE MSC02 1540,ALBUQUERQUE,NM,87131,10708,13611,24319
188225001,1157 County  Rd. 110,Ranchos de Taos,NM,87557,433,786,1219
188049001,280 LA ENTRADA RD,LOS LUNAS,NM,87031,764,1277,2041
159939001,2000 Lakeshore Drive,New Orleans,LA,70148,3949,4202,8151
101879001,1 Harrison Plaza- UNA Box 5067,FLORENCE,AL,356320001,3027,4461,7488
199111001,One University Heights,Asheville,NC,288048510,1611,2151,3762
199120001,"CB 9100, 103 South Building UNC-Chapel Hill",CHAPEL HILL,NC,275999100,12563,17448,30011
199139001,9201 UNIVERSITY CITY BLVD,CHARLOTTE,NC,282230001,15267,14443,29710
199148001,1000 SPRING GARDEN STREET,GREENSBORO,NC,274026170,6620,13486,20106
199281001,ONE UNIVERSITY DRIVE,PEMBROKE,NC,283721510,2677,4460,7137
199184001,1533 S MAIN ST,Winston-Salem,NC,271272188,491,551,1042
199218001,601 S COLLEGE RD,WILMINGTON,NC,284033201,6101,10646,16747
200280001,3851 Campus Road Stop 9035,Grand Forks,ND,582029035,7175,6672,13847
136172001,1 UNF Dr.,Jacksonville,FL,322242648,7113,9663,16776
482680001,82 COLLEGE CIRCLE,DAHLONEGA,GA,30597,8458,11264,19722
227216001,Chestnut Ave.,DENTON,TX,762031277,17654,20587,38241
484905001,7300 University Hills Blvd,Dallas,TX,75241,1206,2551,3757
228909001,3500 CAMP BOWIE BLVD,FORT WORTH,TX,761072699,926,1350,2276
127741001,CARTER HALL - RM 4000,GREELEY,CO,80639,4327,9110,13437
154095001,1222 W 27TH ST,CEDAR FALLS,IA,50614,4459,6728,11187
204486001,1441 n.cable rd,Lima,OH,45805,2779,641,3420
174491001,3003 SNELLING AVE N,SAINT PAUL,MN,551131598,1400,2223,3623
152080001,204 Hammes Mowbray Hall,Notre Dame,IN,46556,6813,5794,12607
207342001,1105 Stonewall Avenue,Oklahoma City,OK,73117,1046,2080,3126
207500001,660 PARRINGTON OVAL,NORMAN,OK,730193072,14066,14498,28564
209551001,110 JOHNSON HALL,EUGENE,OR,97403,10477,12167,22644
215062001,1 COLLEGE HALL 34TH AND SPRUCE STS,PHILADELPHIA,PA,191046380,11673,14187,25860
484613002,4025 S. Riverpoint Parkway,Phoenix,AZ,85040,29836,65941,95777
484631001,3150 Bristol Street,Costa Mesa,CA,926263088,4237,2715,6952
157535001,147 SYCAMORE ST,PIKEVILLE,KY,41501,1113,1204,2317
215266001,300 CAMPUS DRIVE,BRADFORD,PA,16701,569,712,1281
215275001,150 Finoli Drive,GREENSBURG,PA,15601,690,818,1508
215284001,450 SCHOOLHOUSE RD,JOHNSTOWN,PA,15904,1458,1142,2600
215293001,4200 FIFTH AVE,PITTSBURGH,PA,15260,13264,15409,28673
209825001,5000 N WILLAMETTE BLVD,PORTLAND,OR,972035798,1683,2597,4280
180258001,1301 20th Street South,Great Falls,MT,59405,326,712,1038
243106001,Belt St,Ramey,PR,6046150,1407,1732,3139
243115001,FINCA LAS DUNAS CARR 653 RUTA 129 KM 8,ARECIBO,PR,6144010,1464,2174,3638
243133001,174 Road  #170 Industrial Minillas,Bayamon,PR,9591911,2061,2129,4190
243142001,CARRETERA 887 BO SAN ANTON,Carolina,PR,9844800,1308,2084,3392
243151001,205 Antonio R. Barcelo Ave.,Cayey,PR,736,1076,2031,3107
243179001,Call Box 860,Humacao,PR,792,1215,2085,3300
243197001,"259 Boulevard Alfonso Valdez Mayaguez, PR 00681",MAYAGUEZ,PR,6819000,7128,6096,13224
243203001,"Medical Science Center, Americo Miranda Avenue",San Juan,PR,9365067,781,1472,2253
243212001,2151 Santiago de los Caballeros Avenue,PONCE,PR,7169996,1180,1648,2828
243221001,PONCE DE LEON  AVE,San Juan,PR,9313301,5737,9195,14932
236328001,1500 N WARNER,TACOMA,WA,984161004,1012,1654,2666
121691001,"1200 E. COLTON AVE, PO BOX 3080",REDLANDS,CA,923730999,1888,2710,4598
217484001,85 Briar Lane,KINGSTON,RI,2881,7672,10105,17777
233374001,110 UR Drive,University of Richmond,VA,23173,1843,2159,4002
205203001,218 N COLLEGE AVE,RIO GRANDE,OH,45674,655,1049,1704
195030001,500 Wilson Boulevard,Rochester,NY,146270011,5753,6064,11817
152336001,2701 Spring Street,Fort Wayne,IN,468083994,638,1561,2199
130314001,1678 ASYLUM AVE,WEST HARTFORD,CT,61172791,389,2076,2465
155812001,4100 S 4TH ST TRAFFICWAY,LEAVENWORTH,KS,660485082,545,709,1254
122436001,5998 ALCALA PARK,SAN DIEGO,CA,921102492,3917,5156,9073
122612001,2130 FULTON ST,SAN FRANCISCO,CA,941171080,3869,6844,10713
215929001,800 LINDEN STREET,SCRANTON,PA,18510,2157,3129,5286
219383001,1101 W 22ND ST,SIOUX FALLS,SD,571051699,622,993,1615
102094001,307 N UNIVERSITY BLVD,MOBILE,AL,366880002,5241,9593,14834
218645001,471 UNIVERSITY PKY,AIKEN,SC,29801,1273,2426,3699
218654001,#1 University Blvd.,Bluffton,SC,29909,666,1450,2116
218663001,Osborne Building,COLUMBIA,SC,29208,15687,19108,34795
218672001,476 Hubbard  Dr.,LANCASTER,SC,29720,592,931,1523
218690001,200 MILLER RD,SUMTER,SC,291502498,506,604,1110
218706001,309 East Academy st.,UNION,SC,29379,412,681,1093
218742001,800 University Way,Spartanburg,SC,293034932,2099,4076,6175
219471001,414 E CLARK ST,VERMILLION,SD,570692390,3872,6194,10066
137351001,4202 EAST FOWLER AVE  UPB002,TAMPA,FL,336209951,19561,24285,43846
451671001,8350 N Tamiami Trail,Sarasota,FL,342432049,809,1260,2069
448840001,140 Seventh Ave S.,Saint Petersburg,FL,33701,1731,2996,4727
123961001,University Park,Los Angeles,CA,900895012,21903,25407,47310
151306001,8600 UNIVERSITY BLVD,EVANSVILLE,IN,477123597,4075,6911,10986
161554001,37 College Ave.,Gorham,ME,40381038,3209,4931,8140
176372001,"118 College Drive, Box 5001",HATTIESBURG,MS,394065001,5293,9216,14509
148584001,500 N WILCOX ST,JOLIET,IL,604356188,976,2951,3927
174914001,2115 SUMMIT AVE,SAINT PAUL,MN,551051096,5124,4911,10035
367954001,1 University Blvd,Saint Augustine,FL,32086,1273,2502,3775
228635001,5323 HARRY HINES BLVD,DALLAS,TX,753909029,1088,1178,2266
156541001,6191 College Station Drive,WILLIAMSBURG,KY,40769,7006,6466,13472
131399001,"4200 Connecticut Avenue, N.W.",Washington,DC,200081122,1791,2453,4244
225627001,4301 BROADWAY,SAN ANTONIO,TX,78209,3336,4927,8263
120883001,3601 PACIFIC AVE,STOCKTON,CA,95211,2870,3623,6493
215132001,600 S 43RD ST,PHILADELPHIA,PA,191044495,786,1445,2231
243665001,#2 JOHN BREWERS BAY,CHARLOTTE AMALIE,VI,8029990,632,1352,1984
206084001,2801 West Bancroft Street,Toledo,OH,436063390,9957,10280,20237
207971001,800 Tucker Drive,TULSA,OK,741049700,2421,1944,4365
230764001,"201 PRESIDENTS CIRCLE, Rm 203",SALT LAKE CITY,UT,841129008,17503,15520,33023
231174001,85 S PROSPECT ST,BURLINGTON,VT,54050160,5464,7931,13395
234076001,1827 University Ave,CHARLOTTESVILLE,VA,22904,11352,13287,24639
377555001,18115 Campus Way NE,BOTHELL,WA,980118246,3077,2893,5970
236948001,NONE,SEATTLE,WA,981954550,21989,25411,47400
377564001,1900 COMMERCE ST,TACOMA,WA,984023100,2499,2855,5354
101587001,STATION 1,LIVINGSTON,AL,35470,1464,3736,5200
141334001,1601 MAPLE ST,CARROLLTON,GA,301180001,4618,9115,13733
210438001,2900 NE 132ND AVE,PORTLAND,OR,972303099,458,618,1076
240268001,105 Garfield Avenue,Eau Claire,WI,547024004,4443,7161,11604
240277001,2420 NICOLET DR,GREEN BAY,WI,543117001,3111,5455,8566
240329001,1725 STATE ST,LA CROSSE,WI,546019959,4606,5991,10597
240444001,500 LINCOLN DR,MADISON,WI,53706,21154,22309,43463
240453001,PO BOX 413,MILWAUKEE,WI,53211,12423,14589,27012
240365001,800 Algoma Blvd,Oshkosh,WI,54901,6486,9924,16410
240374001,"900 Wood Road, BOX 2000",Kenosha,WI,531412000,2025,2270,4295
240462001,1 UNIVERSITY PLZ,PLATTEVILLE,WI,538183099,5670,3285,8955
240471001,410 S 3RD ST,RIVER FALLS,WI,54022,2248,3887,6135
240480001,2100 MAIN ST,STEVENS POINT,WI,54481,4151,4935,9086
240417001,PO Box 790,MENOMONIE,WI,547510790,4700,4070,8770
240426001,PO Box 2000 BELKNAP & CATLIN,SUPERIOR,WI,548804500,968,1635,2603
240189001,800 W. Main St.,WHITEWATER,WI,53190,6457,6602,13059
240727001,Dept. 3434 1000 E. University Old Main #206,Laramie,WY,82071,6083,6367,12450
154493001,605 WASHINGTON ST,FAYETTE,IA,521421857,1679,2713,4392
196307001,750 E ADAMS ST,SYRACUSE,NY,13210,609,971,1580
216524001,601 E. MAIN ST,COLLEGEVILLE,PA,194261000,708,727,1435
206349001,2550 LANDER RD,PEPPER PIKE,OH,441244398,104,969,1073
446604001,BERDICHEV RD,MONROE,NY,10950,1940,0,1940
230728001,OLD MAIN HILL,LOGAN,UT,843221400,12774,15158,27932
230737001,800 W University Parkway,OREM,UT,840585999,21004,18927,39931
197045001,1600 BURRSTONE RD,UTICA,NY,135024892,2167,3029,5196
141264001,1500 N PATTERSON,VALDOSTA,GA,31698,3838,7373,11211
138187001,1768 Park Center Drive,ORLANDO,FL,32835,19595,26926,46521
200572001,101 COLLEGE ST  SW,VALLEY CITY,ND,58072,619,928,1547
152600001,"1700 CHAPEL DRIVE, US HWY 30",VALPARAISO,IN,463839978,1648,2138,3786
199838001,"PO BOX 917, 200 Community College Rd./STATE RD 1126",HENDERSON,NC,27536,996,2067,3063
221999001,2101 WEST END AVENUE,NASHVILLE,TN,37240,5762,7062,12824
123651001,55 FAIR DR,COSTA MESA,CA,92626,690,1479,2169
197133001,124 RAYMOND AVE,POUGHKEEPSIE,NY,12604,1010,1446,2456
188340001,86-01 23RD AVE,Flushing,NY,11369,1355,187,1542
125028001,4667 Telegraph Road,Ventura,CA,93003,5829,7483,13312
231165001,1 Main Street,Randolph Center,VT,50610500,854,784,1638
229504001,4400 COLLEGE DR,VERNON,TX,763844092,1110,1944,3054
125091001,18422 BEAR VALLEY RD,VICTORVILLE,CA,923955849,4937,7294,12231
229540001,2200 E RED RIVER,VICTORIA,TX,77901,1261,2599,3860
216597001,800 LANCASTER AVE,VILLANOVA,PA,190851699,5238,5792,11030
152637001,1002 N FIRST ST,VINCENNES,IN,47591,9445,8036,17481
234030001,910 W Franklin St,Richmond,VA,232842024,12132,18565,30697
233903001,100 VHCC Drive,ABINGDON,VA,242120828,974,1413,2387
234085001,Letcher Ave.,LEXINGTON,VA,244500304,1467,218,1685
233921001,330 Sterrett Drive,BLACKSBURG,VA,240610131,19736,14947,34683
234155001,ONE HAYDEN DRIVE,PETERSBURG,VA,23806,1866,2519,4385
234164001,1500 N. Lombardy Street,Richmond,VA,232201711,717,835,1552
234173001,5817 Wesleyan Drive,Virginia Beach,VA,234554637,588,849,1437
233949001,"3095 Colonial Avenue, SW",Roanoke,VA,240154704,3068,3759,6827
365204001,6101 MONTANA AVE,EL PASO,TX,79925,1158,2342,3500
240107001,900 Viterbo Drive,LA CROSSE,WI,546018802,677,1921,2598
222053001,1480 NASHVILLE PKE,GALLATIN,TN,370663188,3597,5557,9154
403487001,2200 COLLEGE DR,MOUNT CARMEL,IL,62863,1957,820,2777
197197001,631 Howard Avenue,Staten Island,NY,103014495,752,1466,2218
199847001,1834 Wake Forest Rd.,Winston-Salem,NC,27109,3838,4563,8401
199856001,9101 FAYETTEVILLE RD,RALEIGH,NC,276035696,9990,11882,21872
125231001,"100 Washington Avenue South, Suite 900",MINNEAPOLIS,MN,55401,10601,39759,50360
154518001,106 S. SIXTH ST,FOREST CITY,IA,50436,1973,1177,3150
236887001,500 TAUSICK WAY,WALLA WALLA,WA,993629267,2075,1785,3860
236896001,204 S COLLEGE AVE,COLLEGE PLACE,WA,993241198,866,988,1854
172608001,3838 Livernois,TROY,MI,480835048,1006,1000,2006
206437001,2020 East Maple Street,North Canton,OH,44720,1017,1762,2779
222062001,500 S. Davy Crockett Parkway,Morristown,TN,378136899,2298,3846,6144
138275001,13895 US 27,LAKE WALES,FL,338598797,577,539,1116
245625001,475 RTE 57 WEST,WASHINGTON,NJ,78824343,1631,1865,3496
154527001,100 Wartburg Blvd.,WAVERLY,IA,506770903,702,796,1498
155423001,5724 HUNTOON,TOPEKA,KS,66604,863,554,1417
156082001,1700 SW COLLEGE AVENUE,TOPEKA,KS,666211110,2553,4018,6571
216667001,60 S LINCOLN ST,WASHINGTON,PA,15301,692,665,1357
162210001,7600 FLOWER AVE,TAKOMA PARK,MD,209127794,407,724,1131
234207001,204 West Washington Street,LEXINGTON,VA,24450,1128,1095,2223
164216001,300 WASHINGTON AVE,CHESTERTOWN,MD,216201438,558,809,1367
206446001,710 COLEGATE DR,MARIETTA,OH,45750,626,1171,1797
236939001,French Administration Building,Pullman,WA,991645910,14875,16603,31478
179867001,ONE BROOKINGS DR,SAINT LOUIS,MO,63130,7442,8410,15852
172617001,4800 E HURON RIVER DR,ANN ARBOR,MI,481054800,5828,6436,12264
149727001,RT 47 AT WAUBONSEE DRIVE,SUGAR GROVE,IL,605549454,4229,4947,9176
240125001,800 MAIN ST,PEWAUKEE,WI,53072,4014,3947,7961
229780001,1900 W 7TH,PLAINVIEW,TX,79072,2176,2328,4504
199892001,3000 Wayne Memorial Drive,Goldsboro,NC,275348002,1274,1964,3238
172635001,1001 W FORT ST,DETROIT,MI,48226,5276,9681,14957
181783001,1111 MAIN ST,WAYNE,NE,68787,1542,2091,3633
172644001,656 W Kirby,Detroit,MI,48202,11614,15411,27025
216694001,51 W COLLEGE ST,WAYNESBURG,PA,15370,700,974,1674
229799001,225 COLLEGE PARK DRIVE,WEATHERFORD,TX,760865699,2415,3974,6389
230782001,3750 HARRISON BLVD,OGDEN,UT,844081137,12633,15614,28247
179894001,470 E LOCKWOOD,SAINT LOUIS,MO,631193194,4923,6483,11406
190424001,1300 YORK AVE,NEW YORK,NY,10065,567,681,1248
168218001,106 CENTRAL ST,WELLESLEY,MA,24818203,60,2474,2534
236975001,1300 FIFTH ST,WENATCHEE,WA,988011799,1422,2022,3444
168227001,550 HUNTINGTON AVE,BOSTON,MA,21155998,3526,990,4516
131098001,120 N STATE ST,DOVER,DE,199013875,584,767,1351
130697001,45 Wyllys Ave.,MIDDLETOWN,CT,6459,1450,1767,3217
216764001,700 South High Street,WEST CHESTER,PA,19383,6945,10582,17527
443331001,12215 Victory Blvd.,Los Angeles,CA,91606,440,1551,1991
458229001,2855 E. Guasti Road,Ontario,CA,91761,400,1271,1671
458210001,1477 S. Manchester Ave,Anaheim,CA,92802,740,2684,3424
139278001,997 S. Hwy 16,Carrollton,GA,30116,2509,4675,7184
125462001,300 Cherry Lane,Coalinga,CA,93210,2001,2622,4623
448594001,555 College Avenue,Lemoore,CA,93245,1578,2661,4239
157483001,4810 Alben Barkley Drive,Paducah,KY,42001,2808,3385,6193
237932001,208 University Drive,WEST LIBERTY,WV,26074,926,1600,2526
125471001,9000 Overland Ave.,Culver City,CA,902303519,4653,7090,11743
172671001,3000 N STILES RD,SCOTTVILLE,MI,494540277,377,665,1042
229814001,2501 4TH AVE WTAMU BOX 60999,CANYON,TX,79016,4248,5781,10029
125499001,14000 FRUITVALE AVE,SARATOGA,CA,950705698,3457,4366,7823
238014001,1704 Market Street,Wheeling,WV,260033699,521,1020,1541
237899001,5000 Fairlawn Ave.,INSTITUTE,WV,25112,1505,2187,3692
238032001,P.O. Box 6563 University Police,MORGANTOWN,WV,265066563,13439,13425,26864
237686001,300 Campus Dr.,Parkersburg,WV,261048647,909,1494,2403
237950001,410 Neville Street,Beckley,WV,25801,940,815,1755
237969001,59 College Avenue,Buckhannon,WV,262012994,564,730,1294
490133001,"16715 Von Karman Avenue, #100",Irvine,CA,92606,974,786,1760
200004001,Western Carolina University,CULLOWHEE,NC,287239646,5047,6592,11639
130776001,181 WHITE ST,DANBURY,CT,68106860,2575,3067,5642
219480001,800 MICKELSON DR,RAPID CITY,SD,577034018,482,579,1061
433387002,"2900 South Harbor Blvd, Suite 201",Santa Ana,CA,92704,42135,79302,121437
149772001,1 UNIVERSITY CIRCLE,MACOMB,IL,61455,3990,4512,8502
154572001,4647 Stone Ave,Sioux City,IA,511061997,2357,3317,5674
157951001,1906 College Heights Blvd #11050,Bowling Green,KY,421011050,7735,11721,19456
172699001,1903 West Michigan Avenue,Kalamazoo,MI,490085167,11033,11529,22562
172477001,300 S CAPITOL AVE,LANSING,MI,48933,553,772,1325
181817001,1601 E 27TH ST,SCOTTSBLUFF,NE,693611899,703,1122,1825
182564001,2201 West College Parkway,Carson City,NV,897037399,1407,1920,3327
168254001,1215 WILBRAHAM RD,SPRINGFIELD,MA,11192684,2134,1646,3780
188304001,1000 W. COLLEGE AVE,SILVER CITY,NM,88061,1050,2198,3248
208035001,2801 N. Main Street,Altus,OK,735211397,458,820,1278
210429001,345 Monmouth  Ave N,Monmouth,OR,973611394,1936,3249,5185
199908001,1001 BURKEMONT AVE,MORGANTON,NC,286554511,689,1090,1779
128391001,1 Western Way,GUNNISON,CO,81231,1609,1425,3034
229832001,6200 COLLEGE AVE,SNYDER,TX,795499502,1075,1104,2179
112525001,309 E 2ND ST,POMONA,CA,917661854,1508,2325,3833
237011001,516 High St,Bellingham,WA,982255996,6913,9208,16121
240693001,2500 COLLEGE DR,ROCK SPRINGS,WY,829020428,1474,1709,3183
168263001,577 WESTERN AVE,WESTFIELD,MA,10861630,2613,3487,6100
125727001,955 LA PAZ RD,SANTA BARBARA,CA,931081089,494,783,1277
216825001,145 Pavillion Lane,YOUNGWOOD,PA,156971895,1749,3099,4848
229841001,911 BOLING HWY,WHARTON,TX,77488,2940,3828,6768
237039001,237 W KELLOGG RD,BELLINGHAM,WA,98226,1844,2419,4263
149781001,501 E COLLEGE AVE,WHEATON,IL,601875593,1321,1623,2944
238078001,316 WASHINGTON AVE,WHEELING,WV,26003,568,603,1171
237057001,345 BOYER AVE,WALLA WALLA,WA,99362,633,842,1475
125763001,13406 PHILADELPHIA ST,WHITTIER,CA,90608,762,1090,1852
237066001,300 W HAWTHORNE RD,SPOKANE,WA,99251,1062,1714,2776
156125001,1845 FAIRMOUNT,WICHITA,KS,672600001,7150,8628,15778
156107001,4004 N Webb Rd. Bldg 100,Wichita,KS,67226,2309,2287,4596
216852001,ONE UNIVERSITY PLACE,CHESTER,PA,190135792,2334,4287,6621
229887001,711 Wiley Avenue,Marshall,TX,75670,434,569,1003
199926001,1328 SOUTH COLLEGIATE DR,WILKESBORO,NC,28697,1166,1435,2601
216931001,84 West South Street,Wilkes-Barre,PA,18766,1923,3209,5132
210401001,900 STATE ST,SALEM,OR,97301,1053,1310,2363
176479001,710 William Carey Parkway,HATTIESBURG,MS,394015499,1812,3230,5042
122728001,2121 University Ave,Rocklin,CA,95765,707,988,1695
187444001,300 POMPTON RD,WAYNE,NJ,74702103,4318,5880,10198
154590001,201 Trueblood Avenue,Oskaloosa,IA,52577,709,570,1279
149842001,1200 W ALGONQUIN RD,PALATINE,IL,600677398,6130,7400,13530
138479001,6500 NOVA DR,DAVIE,FL,33317,642,462,1104
179964001,ONE UNIVERSITY AVENUE,FULTON,MO,652511098,833,1469,2302
168342001,880 MAIN ST. PO Box 368,WILLIAMSTOWN,MA,12670368,1113,1036,2149
200341001,1410 UNIVERSITY AVE,WILLISTON,ND,588011326,421,703,1124
206507001,1870 Quaker Way,WILMINGTON,OH,45177,616,644,1260
131113001,320 DUPONT HWY,NEW CASTLE,DE,19720,5204,9582,14786
217013001,1015 Philadelphia Ave.,Chambersburg,PA,172011285,312,1187,1499
199953001,902 HERRING AVE,WILSON,NC,278933310,557,1135,1692
234359001,243 Woodrow Wilson Ave.,FISHERSVILLE,VA,229391500,,,
141990001,45-720 Keaahala Road,Kaneohe,HI,96744,916,1544,2460
199962001,P.O. Box 159,Wingate,NC,281740157,1438,2251,3689
175272001,175 West Mark Street,WINONA,MN,559870838,2757,5035,7792
199999001,601 MARTIN LUTHER KING JR. DR.,WINSTON-SALEM,NC,271100001,1425,3765,5190
218964001,"701 Oakland Ave, 119 Tillman Hall",Rock Hill,SC,29733,1701,4112,5813
141255001,4089 Val Tech Road,Valdosta,GA,316020928,1868,2905,4773
240198001,2100 Beaser Ave,Ashland,WI,54806,1102,1861,2963
240338001,8800 W BLUEMOUND RD,MILWAUKEE,WI,532264699,539,709,1248
206525001,200 W. Ward Street,SPRINGFIELD,OH,455042199,811,990,1801
218973001,429 N CHURCH ST,SPARTANBURG,SC,293033663,779,887,1666
125897001,7500 GLENOAKS BLVD,BURBANK,CA,915107846,565,608,1173
455512001,2300 E Gibson Rd,Woodland,CA,95776,1410,2256,3666
164313001,32000 Campus Drive,Salisbury,MD,21804,1074,1950,3024
168421001,100 INSTITUTE RD,WORCESTER,MA,16092280,4420,2454,6874
168430001,486 CHANDLER ST,WORCESTER,MA,16022597,2366,3851,6217
206613001,7600 St. Rt. 703,Celina,OH,458222952,456,607,1063
206604001,3640 Colonel Glenn Highway,Dayton,OH,454350001,6706,7697,14403
234377001,1000 E MAIN ST,WYTHEVILLE,VA,243823308,945,1569,2514
206622001,3800 VICTORY PKY,CINCINNATI,OH,452071092,3092,4035,7127
160904001,1 Drexel Drive,NEW ORLEANS,LA,70125,822,2409,3231
237109001,Sixteenth Ave. and Nob Hill Boulevard,YAKIMA,WA,989072520,1572,2884,4456
130794001,105 Wall Street,NEW HAVEN,CT,6520,6558,6875,13433
106148001,1100 E Sheldon St,Prescott,AZ,863013297,3011,4303,7314
197708001,500 West 185 Street,NEW YORK,NY,100333299,3027,3452,6479
217059001,441 COUNTRY CLUB RD,YORK,PA,174033651,1962,2355,4317
420440001,112 COLLEGE DR,WELLS,ME,4090,594,1038,1632
218991001,452 S ANDERSON RD,ROCK HILL,SC,29730,1791,2462,4253
141361001,1 College Street,YOUNG HARRIS,GA,30582,639,786,1425
206695001,One University Plaza,Youngstown,OH,44555,5873,6734,12607
217077001,1405 WILLIAMS RD,YORK,PA,17402,487,840,1327
126119001,2088 N BEALE RD,MARYSVILLE,CA,95901,2286,3648,5934
204255001,1555 Newark Road,Zanesville,OH,437019938,972,1303,2275